area_code,area_name,census_geography,all_households,owned,own_outright,own_mortgage,shared_own,rent_social,rent_council,rent_other,private_rent,private_landlord,private_other,rent_free,owned_perc,rent_social_perc,private_rent_perc,centroid_x,centroid_y
W06000014,Vale of Glamorgan,la,53505,38647,18954,19693,125,6354,4025,2329,7813,6780,1033,566,72.2,11.9,14.6,302625.71221693687,173083.2783448837
W06000015,Cardiff,la,142557,84262,37788,46474,639,24374,13547,10827,31220,28972,2248,2062,59.1,17.1,21.9,316407.00000592414,174926.57615038028
W06000022,Newport,la,61172,39272,18229,21043,325,12122,5981,6141,8572,7870,702,881,64.2,19.8,14.0,333356.79405248025,186752.70034474696
W06000016,Rhondda Cynon Taf,la,99663,70760,36338,34422,150,13673,6836,6837,13604,12334,1270,1476,71.0,13.7,13.7,302236.23722295207,197166.84563830242
W06000018,Caerphilly,la,74479,51632,24188,27444,216,13962,10464,3498,7995,7178,817,674,69.3,18.7,10.7,317244.1408230999,197757.03416726863
W02000423,Cardiff 049,msoa,4132,1258,391,867,30,1113,752,361,1633,1558,75,98,30.4,26.9,39.5,318618.12511961395,174962.34705778724
W02000401,Cardiff 035,msoa,2688,1931,858,1073,4,246,32,214,469,440,29,38,71.8,9.2,17.4,315454.1615837222,176941.41802861867
W02000406,Cardiff 040,msoa,3566,2304,998,1306,11,419,157,262,779,718,61,53,64.6,11.7,21.8,315929.2272543325,175957.24295692833
W02000378,Cardiff 012,msoa,3096,2560,1338,1222,8,107,43,64,394,362,32,27,82.7,3.5,12.7,316013.34715396364,180885.61441988277
W02000240,The Vale of Glamorgan 004,msoa,3628,2758,1347,1411,8,459,271,188,370,296,74,33,76.0,12.7,10.2,317029.40585623286,172438.11839127637
W02000400,Cardiff 034,msoa,3147,1598,687,911,8,234,35,199,1269,1229,40,38,50.8,7.4,40.3,316724.13716677355,177369.28883387134
W02000310,Caerphilly 021,msoa,2215,1522,710,812,6,504,493,11,162,142,20,21,68.7,22.8,7.3,320260.5282645477,187209.2980906947
W02000386,Cardiff 020,msoa,3349,2752,1543,1209,8,215,136,79,329,302,27,45,82.2,6.4,9.8,315542.1435410684,180054.16599766392
W02000387,Cardiff 021,msoa,2419,1995,1054,941,6,55,30,25,342,311,31,21,82.5,2.3,14.1,316534.8233989328,179882.69938471977
W02000384,Cardiff 018,msoa,2322,1965,1017,948,15,94,40,54,231,204,27,17,84.6,4.0,9.9,317550.9609321383,179967.79436724854
W02000385,Cardiff 019,msoa,2453,2040,1140,900,6,62,8,54,329,310,19,16,83.2,2.5,13.4,318931.73089975474,179967.89790040077
W02000383,Cardiff 017,msoa,3027,1887,750,1137,16,755,633,122,342,310,32,27,62.3,24.9,11.3,320028.80355946417,180077.89351950734
W02000367,Cardiff 001,msoa,2456,2153,1156,997,17,21,12,9,231,211,20,34,87.7,0.9,9.4,318112.1535024042,183540.9266083678
W02000370,Cardiff 004,msoa,2957,2704,1707,997,6,16,7,9,209,189,20,22,91.4,0.5,7.1,315466.19002279395,182819.66194350368
W02000382,Cardiff 016,msoa,2342,1142,504,638,9,944,624,320,189,163,26,58,48.8,40.3,8.1,322749.2920302189,180021.5445260411
W02000379,Cardiff 013,msoa,2562,789,250,539,21,1486,483,1003,228,203,25,38,30.8,58.0,8.9,323625.40885052015,180923.73970999802
W02000239,The Vale of Glamorgan 003,msoa,2688,2338,1278,1060,1,79,71,8,224,191,33,46,87.0,2.9,8.3,307395.09128592815,172945.20075659265
W02000277,Rhondda Cynon Taf 026,msoa,3098,2124,950,1174,16,602,293,309,307,272,35,49,68.6,19.4,9.9,311566.88545201515,185662.7045601383
W02000404,Cardiff 038,msoa,2786,1256,486,770,5,902,78,824,561,506,55,62,45.1,32.4,20.1,320137.30289849057,176413.19151841872
W02000403,Cardiff 037,msoa,3077,1540,477,1063,5,981,652,329,487,434,53,64,50.0,31.9,15.8,321271.4848485954,176861.40012527682
W02000388,Cardiff 022,msoa,2384,1845,896,949,1,299,175,124,222,192,30,17,77.4,12.5,9.3,321965.14948186494,178662.45996821942
W02000375,Cardiff 009,msoa,2783,1634,488,1146,19,725,468,257,380,340,40,25,58.7,26.1,13.7,320579.61476656364,180624.39380982492
W02000381,Cardiff 015,msoa,2799,1737,825,912,8,725,635,90,272,232,40,57,62.1,25.9,9.7,321687.65765538416,180215.05874170273
W02000410,Cardiff 044,msoa,3039,1594,694,900,9,486,143,343,881,816,65,69,52.5,16.0,29.0,317772.248829523,175402.7775575231
W02000408,Cardiff 042,msoa,3011,1050,492,558,15,795,277,518,1081,1025,56,70,34.9,26.4,35.9,317299.1560895332,176286.47525633706
W02000398,Cardiff 032,msoa,3453,577,320,257,19,241,81,160,2544,2361,183,72,16.7,7.0,73.7,317959.0454378823,176979.98436992243
W02000394,Cardiff 028,msoa,2739,890,460,430,16,81,15,66,1717,1617,100,35,32.5,3.0,62.7,317951.72353768157,178375.20505895797
W02000373,Cardiff 007,msoa,2668,1466,615,851,2,896,705,191,244,225,19,60,54.9,33.6,9.1,322588.40423120663,181375.121819115
W02000376,Cardiff 010,msoa,2989,2057,969,1088,9,639,381,258,256,230,26,28,68.8,21.4,8.6,313880.2201269126,182058.28384689707
W02000368,Cardiff 002,msoa,2488,1976,783,1193,51,90,18,72,353,331,22,18,79.4,3.6,14.2,317055.78963273147,182947.95795937997
W02000369,Cardiff 003,msoa,3115,2328,599,1729,35,195,5,190,534,501,33,23,74.7,6.3,17.1,321946.49976866436,183085.80415493637
W02000399,Cardiff 033,msoa,4602,1239,577,662,17,638,97,541,2656,2520,136,52,26.9,13.9,57.7,319276.1774547001,177295.50443569018
W02000402,Cardiff 036,msoa,4064,1318,488,830,19,1088,200,888,1551,1464,87,88,32.4,26.8,38.2,319762.9575245634,176950.699963194
W02000396,Cardiff 030,msoa,2963,1229,552,677,18,160,77,83,1515,1428,87,41,41.5,5.4,51.1,318867.44077411183,178257.26712803706
W02000395,Cardiff 029,msoa,2727,1733,750,983,3,242,8,234,724,685,39,25,63.5,8.9,26.5,320227.0097875482,178355.99962600775
W02000390,Cardiff 024,msoa,2365,2007,1176,831,9,102,9,93,228,209,19,19,84.9,4.3,9.6,319795.8285386419,178955.58785246368
W02000374,Cardiff 008,msoa,2293,2044,1135,909,5,41,12,29,176,160,16,27,89.1,1.8,7.7,319229.36908083636,181349.99125136307
W02000412,Cardiff 046,msoa,2804,1517,613,904,11,560,233,327,646,604,42,70,54.1,20.0,23.0,317410.07679263654,174997.84924464396
W02000422,Cardiff 048,msoa,3654,1172,282,890,54,214,21,193,2185,2086,99,29,32.1,5.9,59.8,319494.12760848907,170171.27437436898
W02000391,Cardiff 025,msoa,2426,1179,516,663,18,251,158,93,928,812,116,50,48.6,10.3,38.3,317053.523163438,178608.11445396586
W02000371,Cardiff 005,msoa,3989,2573,1126,1447,33,820,578,242,497,449,48,66,64.5,20.6,12.5,317748.78187170904,181776.48083822106
W02000392,Cardiff 026,msoa,3794,3047,1551,1496,9,142,13,129,539,499,40,57,80.3,3.7,14.2,314848.42851463234,178393.50785419712
W02000393,Cardiff 027,msoa,2963,1791,739,1052,14,744,654,90,366,322,44,48,60.4,25.1,12.4,313524.564148278,178341.46818095483
W02000397,Cardiff 031,msoa,2985,1876,888,988,8,733,438,295,309,274,35,59,62.8,24.6,10.4,313843.8804615948,177536.20537766753
W02000405,Cardiff 039,msoa,2996,1012,384,628,4,1682,1596,86,248,228,20,50,33.8,56.1,8.3,313246.7454842016,176588.02629035947
W02000407,Cardiff 041,msoa,2637,1278,527,751,9,1036,712,324,267,235,32,47,48.5,39.3,10.1,314486.2806574489,176231.06466606655
W02000242,The Vale of Glamorgan 006,msoa,3333,2718,1531,1187,7,348,173,175,233,195,38,27,81.5,10.4,7.0,314669.93862747983,172267.6511891968
W02000389,Cardiff 023,msoa,3504,2112,895,1217,9,899,635,264,438,400,38,46,60.3,25.7,12.5,315420.8362349494,179063.82508542857
W02000372,Cardiff 006,msoa,3060,2603,1206,1397,4,157,56,101,269,246,23,27,85.1,5.1,8.8,312376.4501658448,181867.14267800216
W02000380,Cardiff 014,msoa,2764,2407,1083,1324,2,102,86,16,224,198,26,29,87.1,3.7,8.1,310168.7783747446,180058.52360947695
W02000409,Cardiff 043,msoa,2541,1521,674,847,6,779,652,127,188,156,32,47,59.9,30.7,7.4,312298.2939946976,175499.46115497436
W02000411,Cardiff 045,msoa,2703,1437,545,892,7,892,519,373,331,288,43,36,53.2,33.0,12.2,312929.362842845,175344.27200916177
W02000366,Newport 020,msoa,3193,2621,946,1675,22,131,52,79,388,353,35,31,82.1,4.1,12.2,326833.09589914547,184132.50562584517
W02000377,Cardiff 011,msoa,2876,2139,584,1555,21,270,168,102,429,389,40,17,74.4,9.4,14.9,324086.03961420053,179997.14018928944
W01001945,Cardiff 048D,lsoa,838,223,54,169,12,9,4,5,588,565,23,6,26.6,1.1,70.2,317985.240791411,173170.06166257316
W01001762,Cardiff 046D,lsoa,736,256,93,163,4,247,124,123,197,185,12,32,34.8,33.6,26.8,317847.6588320238,174330.72231915547
W01001761,Cardiff 046C,lsoa,724,323,138,185,1,160,45,115,218,206,12,22,44.6,22.1,30.1,317770.376610388,174807.87490715488
W01001760,Cardiff 046B,lsoa,670,438,201,237,1,109,53,56,111,104,7,11,65.4,16.3,16.6,318271.7779509862,174597.32094699456
W01001768,Cardiff 044E,lsoa,539,267,118,149,1,60,15,45,191,177,14,20,49.5,11.1,35.4,317795.73532268766,175114.46946316413
W01001765,Cardiff 044B,lsoa,521,298,145,153,3,71,6,65,140,128,12,9,57.2,13.6,26.9,318034.9700517446,175236.83380225793
W01001944,Cardiff 048C,lsoa,580,207,39,168,1,23,1,22,346,328,18,3,35.7,4.0,59.7,319172.73353598046,175360.28469841514
W01001941,Cardiff 032G,lsoa,670,138,59,79,5,16,1,15,483,460,23,28,20.6,2.4,72.1,318370.0264991199,176122.04859170687
W01001922,Cardiff 032E,lsoa,424,39,33,6,5,39,10,29,336,311,25,5,9.2,9.2,79.2,318441.67343972024,177174.89746943806
W01001835,Cardiff 033F,lsoa,908,212,110,102,3,288,23,265,394,372,22,11,23.3,31.7,43.4,319163.1064928849,176989.70806852786
W01001722,Cardiff 028D,lsoa,514,131,75,56,3,18,4,14,354,341,13,8,25.5,3.5,68.9,317994.5730386287,177950.67752156605
W01001832,Cardiff 033C,lsoa,741,67,35,32,4,52,7,45,611,594,17,7,9.0,7.0,82.5,318822.75299932214,177364.13178028178
W01001829,Cardiff 033A,lsoa,663,188,90,98,2,54,8,46,413,378,35,6,28.4,8.1,62.3,318952.3067351652,177576.1399080316
W01001720,Cardiff 028C,lsoa,590,128,71,57,3,17,4,13,436,420,16,6,21.7,2.9,73.9,318311.6762975676,177957.33048299738
W01001718,Cardiff 028A,lsoa,577,185,81,104,6,12,1,11,366,345,21,8,32.1,2.1,63.4,318292.06895463704,178205.4464774337
W01001726,Cardiff 028E,lsoa,524,168,72,96,1,24,3,21,323,299,24,8,32.1,4.6,61.6,317987.79620204493,178643.3277225744
W01001732,Cardiff 019A,lsoa,667,564,333,231,2,1,0,1,96,90,6,4,84.6,0.1,14.4,318582.2438484572,180596.2325995843
W01001863,Cardiff 022A,lsoa,637,487,222,265,0,66,33,33,79,69,10,5,76.5,10.4,12.4,322043.57605008455,178872.9684212532
W01001864,Cardiff 022B,lsoa,623,548,294,254,0,15,6,9,55,48,7,5,88.0,2.4,8.8,321492.14911038417,179362.10779155957
W01001816,Cardiff 009B,lsoa,1065,583,132,451,13,302,216,86,153,138,15,14,54.7,28.4,14.4,320919.38247148704,181428.06049558803
W01001951,Cardiff 049E,lsoa,548,205,52,153,1,52,12,40,281,262,19,9,37.4,9.5,51.3,319130.1531423386,175914.43031953776
W01001952,Cardiff 049F,lsoa,621,171,45,126,11,77,43,34,348,336,12,14,27.5,12.4,56.0,318418.24622610374,175452.54005560747
W01001711,Cardiff 040C,lsoa,720,419,215,204,1,184,128,56,98,91,7,18,58.2,25.6,13.6,316203.69648416643,175555.5168494717
W01001716,Cardiff 035C,lsoa,543,434,194,240,0,8,5,3,91,88,3,10,79.9,1.5,16.8,314968.5154869864,177004.39911161043
W01001709,Cardiff 040A,lsoa,721,483,184,299,3,86,7,79,139,127,12,10,67.0,11.9,19.3,315587.4100512841,176385.62841007166
W01001714,Cardiff 035A,lsoa,612,538,272,266,0,11,6,5,53,46,7,10,87.9,1.8,8.7,315450.4520412459,176941.41832862524
W01001782,Cardiff 026D,lsoa,591,548,279,269,2,3,2,1,35,33,2,3,92.7,0.5,5.9,315011.87099834334,177563.36343797957
W01001781,Cardiff 026C,lsoa,829,536,305,231,0,71,3,68,192,180,12,30,64.7,8.6,23.2,315697.5290266145,177869.63622136708
W01001786,Cardiff 023B,lsoa,628,467,196,271,2,72,53,19,78,68,10,9,74.4,11.5,12.4,315211.3505782571,178771.97737299945
W01001785,Cardiff 023A,lsoa,482,199,90,109,3,238,120,118,33,26,7,9,41.3,49.4,6.8,315711.8426125762,179035.13922929703
W01001889,Cardiff 020B,lsoa,747,555,321,234,0,80,46,34,103,96,7,9,74.3,10.7,13.8,315846.33175113495,180024.07937946572
W01001852,Cardiff 004B,lsoa,723,677,361,316,2,5,3,2,34,31,3,5,93.6,0.7,4.7,315557.37112023454,183003.6531699536
W01001104,The Vale of Glamorgan 004E,lsoa,864,682,351,331,0,72,10,62,103,84,19,7,78.9,8.3,11.9,316707.5554207408,173032.5119750009
W01001710,Cardiff 040B,lsoa,701,468,214,254,3,31,8,23,189,181,8,10,66.8,4.4,27.0,316102.42249586864,176511.7835085576
W01001717,Cardiff 035D,lsoa,768,472,181,291,3,144,17,127,138,127,11,11,61.5,18.8,18.0,315852.5780742257,176971.18944461693
W01001712,Cardiff 040D,lsoa,679,453,195,258,2,26,6,20,191,176,15,7,66.7,3.8,28.1,316361.20647613064,176748.51056765593
W01001715,Cardiff 035B,lsoa,765,487,211,276,1,83,4,79,187,179,8,7,63.7,10.8,24.4,316012.94367676566,177112.17626137784
W01001858,Cardiff 034A,lsoa,869,381,193,188,5,87,6,81,387,378,9,9,43.8,10.0,44.5,316582.9060015113,177629.86517420766
W01001788,Cardiff 023D,lsoa,608,295,117,178,1,249,227,22,49,44,5,14,48.5,41.0,8.1,316065.8039755076,178574.56730447107
W01001787,Cardiff 023C,lsoa,556,322,128,194,0,173,120,53,58,55,3,3,57.9,31.1,10.4,316404.2883713633,178983.53799257995
W01001658,Newport 020D,lsoa,697,579,220,359,1,65,34,31,46,41,5,6,83.1,9.3,6.6,326533.4556828396,182260.35567539692
W01001808,Cardiff 007C,lsoa,638,238,85,153,1,326,300,26,55,52,3,18,37.3,51.1,8.6,321972.16743152123,181453.1882794492
W01001241,Rhondda Cynon Taf 026D,lsoa,756,512,199,313,6,144,75,69,86,70,16,8,67.7,19.0,11.4,312724.9213323827,183568.6413201884
W01001798,Cardiff 002D,lsoa,624,521,251,270,6,15,9,6,76,74,2,6,83.5,2.4,12.2,316732.80973315146,182576.8974918238
W01001851,Cardiff 012D,lsoa,697,567,327,240,4,50,19,31,71,62,9,5,81.3,7.2,10.2,315557.6746175932,181025.6780495372
W01001854,Cardiff 004D,lsoa,834,755,518,237,1,4,1,3,66,58,8,8,90.5,0.5,7.9,316109.80670907727,181807.84630464492
W01001887,Cardiff 020A,lsoa,613,556,298,258,0,1,1,0,48,44,4,8,90.7,0.2,7.8,314977.8282943473,180017.57332257813
W01001888,Cardiff 010A,lsoa,694,526,209,317,2,86,57,29,73,65,8,7,75.8,12.4,10.5,314135.600253507,180195.4149934938
W01001890,Cardiff 021D,lsoa,608,502,265,237,2,7,1,6,94,92,2,3,82.6,1.2,15.5,316483.66176333436,179638.56904295104
W01001891,Cardiff 020C,lsoa,762,528,284,244,1,118,82,36,99,91,8,16,69.3,15.5,13.0,315410.9817886886,179715.59161292328
W01001892,Cardiff 020D,lsoa,599,565,358,207,1,5,2,3,20,14,6,8,94.3,0.8,3.3,316107.24095778906,179415.75095764425
W01001893,Cardiff 010B,lsoa,793,551,235,316,1,162,70,92,69,63,6,10,69.5,20.4,8.7,313783.2225323797,182961.56831210348
W01001948,Cardiff 006E,lsoa,637,491,138,353,1,31,3,28,110,104,6,4,77.1,4.9,17.3,312756.6307454484,180156.8968415484
W01001953,Cardiff 005G,lsoa,643,400,158,242,10,154,118,36,68,57,11,11,62.2,24.0,10.6,316858.6410710665,181727.40124843208
W01001773,Cardiff 012A,lsoa,991,706,275,431,2,49,19,30,221,209,12,13,71.2,4.9,22.3,316652.56745037227,180444.1868416113
W01001776,Cardiff 021C,lsoa,515,450,235,215,1,2,0,2,59,47,12,3,87.4,0.4,11.5,317117.4798952975,179486.9645164268
W01001949,Cardiff 005F,lsoa,635,319,49,270,13,134,7,127,163,155,8,6,50.2,21.1,25.7,316895.9772853537,181213.63481104947
W01001770,Cardiff 018B,lsoa,476,336,199,137,14,51,27,24,68,59,9,7,70.6,10.7,14.3,317842.7818681769,179648.87513925027
W01001772,Cardiff 021A,lsoa,603,541,310,231,2,8,3,5,47,44,3,5,89.7,1.3,7.8,316152.2808048271,180194.86721146267
W01001789,Cardiff 023E,lsoa,730,522,232,290,0,42,25,17,156,149,7,10,71.5,5.8,21.4,314522.84070591454,179376.87057134602
W01001792,Cardiff 005B,lsoa,705,396,178,218,3,243,224,19,53,46,7,10,56.2,34.5,7.5,317586.08927225583,181060.5024423225
W01001794,Cardiff 001C,lsoa,626,483,191,292,8,4,1,3,125,115,10,6,77.2,0.6,20.0,317712.5339723969,183125.13116749187
W01001795,Cardiff 002B,lsoa,644,516,196,320,19,11,0,11,94,84,10,4,80.1,1.7,14.6,316892.93875464424,183112.1987646707
W01001796,Cardiff 002C,lsoa,653,495,196,299,12,51,8,43,89,83,6,6,75.8,7.8,13.6,317209.97601355927,182840.9703306879
W01001797,Cardiff 005C,lsoa,607,515,247,268,2,29,22,7,48,41,7,13,84.8,4.8,7.9,317582.2117757669,182370.85211540625
W01001809,Cardiff 017A,lsoa,538,412,178,234,1,81,40,41,38,32,6,6,76.6,15.1,7.1,319681.907778889,180326.85262021105
W01001810,Cardiff 017B,lsoa,635,335,104,231,1,224,188,36,67,64,3,8,52.8,35.3,10.6,320191.3922935975,180489.89836612207
W01001813,Cardiff 017D,lsoa,698,312,133,179,11,317,298,19,52,44,8,6,44.7,45.4,7.4,320072.321371389,180013.54439909806
W01001814,Cardiff 017E,lsoa,672,478,196,282,0,64,44,20,128,117,11,2,71.1,9.5,19.0,320046.6103454035,179549.89615646677
W01001815,Cardiff 008D,lsoa,511,432,181,251,4,33,10,23,37,33,4,5,84.5,6.5,7.2,320011.4578494053,181584.97682839242
W01001819,Cardiff 014D,lsoa,912,764,390,374,0,76,73,3,62,48,14,10,83.8,8.3,6.8,309961.1694630933,182346.64748400394
W01001820,Cardiff 006A,lsoa,508,401,176,225,0,73,30,43,27,24,3,7,78.9,14.4,5.3,311693.2517174133,183218.34034321114
W01001896,Cardiff 020E,lsoa,628,548,282,266,6,11,5,6,59,57,2,4,87.3,1.8,9.4,315249.6479761583,180480.3603847506
W01001840,Cardiff 007D,lsoa,755,503,213,290,1,157,49,108,83,77,6,11,66.6,20.8,11.0,323119.8482272534,181509.22298488198
W01001802,Cardiff 007A,lsoa,684,463,225,238,0,147,113,34,55,49,6,19,67.7,21.5,8.0,322574.5956320743,181168.9613219585
W01001879,Cardiff 013A,lsoa,817,320,88,232,17,377,175,202,91,80,11,12,39.2,46.1,11.1,323637.80557883694,180858.03620307395
W01001880,Cardiff 013B,lsoa,573,149,31,118,2,356,102,254,58,55,3,8,26.0,62.1,10.1,324169.1784868598,180957.53225814574
W01001113,The Vale of Glamorgan 003A,lsoa,913,780,446,334,1,42,36,6,73,67,6,17,85.4,4.6,8.0,306236.8773483947,177117.80209097796
W01001135,The Vale of Glamorgan 003C,lsoa,600,515,291,224,0,18,18,0,56,45,11,11,85.8,3.0,9.3,309437.28714040015,172288.8320071897
W01001240,Rhondda Cynon Taf 026C,lsoa,845,685,269,416,2,66,35,31,87,79,8,5,81.1,7.8,10.3,312664.80712559214,184979.70168993747
W01001872,Cardiff 038B,lsoa,662,354,159,195,3,152,13,139,140,130,10,13,53.5,23.0,21.1,320101.256454791,176637.50851963987
W01001874,Cardiff 038D,lsoa,723,184,60,124,0,401,25,376,111,97,14,27,25.4,55.5,15.4,320137.30289849115,175822.17738833692
W01001694,Cardiff 036A,lsoa,878,306,109,197,1,215,59,156,333,316,17,23,34.9,24.5,37.9,319770.33786633017,176939.30945680017
W01001870,Cardiff 037A,lsoa,580,407,145,262,2,75,50,25,93,84,9,3,70.2,12.9,16.0,320570.6143402268,176863.15638893892
W01001698,Cardiff 036E,lsoa,896,264,106,158,7,95,15,80,500,484,16,30,29.5,10.6,55.8,319933.1675215942,177301.0443730184
W01001871,Cardiff 037B,lsoa,679,251,101,150,1,349,232,117,64,58,6,14,37.0,51.4,9.4,321103.75706321304,176870.4021991125
W01001869,Cardiff 038A,lsoa,623,396,149,247,1,107,12,95,109,93,16,10,63.6,17.2,17.5,320390.2191841855,177262.7097622887
W01001697,Cardiff 036D,lsoa,762,414,151,263,3,133,20,113,196,179,17,16,54.3,17.5,25.7,320347.99810449546,177368.79813788252
W01001825,Cardiff 029D,lsoa,774,502,197,305,0,73,3,70,187,169,18,12,64.9,9.4,24.2,320471.2572158646,178077.523180278
W01001875,Cardiff 037C,lsoa,1140,574,115,459,2,281,136,145,256,227,29,27,50.4,24.6,22.5,321300.4592102816,176861.40127526995
W01001828,Cardiff 024D,lsoa,637,587,364,223,1,7,2,5,38,35,3,4,92.2,1.1,6.0,320299.15894635057,178900.51173020474
W01001868,Cardiff 022D,lsoa,609,374,180,194,0,177,129,48,53,42,11,5,61.4,29.1,8.7,322010.5197306038,179549.00423104814
W01001883,Cardiff 016C,lsoa,675,321,150,171,3,302,210,92,40,32,8,9,47.6,44.7,5.9,323115.9145795123,180503.62492457664
W01001884,Cardiff 013D,lsoa,527,13,3,10,0,504,21,483,8,6,2,2,2.5,95.6,1.5,323797.3879479243,180700.30339931662
W01001841,Cardiff 003A,lsoa,740,590,156,434,6,71,1,70,67,64,3,6,79.7,9.6,9.1,320329.08775458595,182754.37346167152
W01001882,Cardiff 011C,lsoa,739,563,130,433,13,24,9,15,137,124,13,2,76.2,3.2,18.5,324870.43581255013,180976.1092935418
W01001843,Cardiff 003C,lsoa,808,662,174,488,1,15,1,14,123,116,7,7,81.9,1.9,15.2,322733.18905566714,182591.84120133283
W01001842,Cardiff 003B,lsoa,726,531,120,411,4,9,0,9,177,169,8,5,73.1,1.2,24.4,321240.7082033047,183433.37667911957
W01001803,Cardiff 015A,lsoa,712,407,189,218,4,237,219,18,47,38,9,17,57.2,33.3,6.6,322211.1570869292,180247.56574680016
W01001805,Cardiff 015C,lsoa,645,352,148,204,1,245,222,23,35,30,5,12,54.6,38.0,5.4,321596.4101043559,180453.91432741637
W01001811,Cardiff 009A,lsoa,540,226,79,147,3,255,230,25,47,43,4,9,41.9,47.2,8.7,320892.52513633046,180477.00077959005
W01001823,Cardiff 029B,lsoa,521,439,190,249,0,7,2,5,75,72,3,0,84.3,1.3,14.4,319687.90128276823,178108.21388617714
W01001865,Cardiff 022C,lsoa,515,436,200,236,1,41,7,34,35,33,2,2,84.7,8.0,6.8,321965.15128197754,178202.9104247234
W01001876,Cardiff 037D,lsoa,678,308,116,192,0,276,234,42,74,65,9,20,45.4,40.7,10.9,320812.29467152053,177348.12850156237
W01001799,Cardiff 001D,lsoa,520,465,285,180,6,6,2,4,38,34,4,5,89.4,1.2,7.3,318474.7023998587,182283.07708122753
W01001844,Cardiff 003D,lsoa,841,545,149,396,24,100,3,97,167,152,15,5,64.8,11.9,19.9,320785.69507312286,182065.03534313262
W01001783,Cardiff 026E,lsoa,508,443,184,259,1,6,3,3,53,50,3,5,87.2,1.2,10.4,313850.8666340961,179335.12842716696
W01001790,Cardiff 023F,lsoa,500,307,132,175,3,125,90,35,64,58,6,1,61.4,25.0,12.8,315265.0054912311,179229.61493339727
W01001757,Cardiff 025C,lsoa,571,267,128,139,4,27,10,17,261,240,21,12,46.8,4.7,45.7,317275.0227764844,178985.37149432627
W01001774,Cardiff 018D,lsoa,541,493,253,240,0,5,4,1,41,37,4,2,91.1,0.9,7.6,317099.3418083176,179966.96331610254
W01001733,Cardiff 019B,lsoa,586,450,252,198,2,52,1,51,76,70,6,6,76.8,8.9,13.0,319266.44970719743,179964.98609239905
W01001812,Cardiff 017C,lsoa,484,350,139,211,3,69,63,6,57,53,4,5,72.3,14.3,11.8,319881.2394315599,180234.27738073564
W01001806,Cardiff 015D,lsoa,799,592,348,244,2,56,19,37,136,122,14,13,74.1,7.0,17.0,321317.65130765154,179803.20573472613
W01001867,Cardiff 016B,lsoa,545,223,88,135,5,248,198,50,50,46,4,19,40.9,45.5,9.2,322497.6754532895,179611.50930539166
W01001895,Cardiff 010D,lsoa,851,400,214,186,5,377,244,133,63,56,7,6,47.0,44.3,7.4,314073.8891558276,180705.13773265426
W01001848,Cardiff 012B,lsoa,618,558,299,259,0,5,3,2,51,46,5,4,90.3,0.8,8.3,316282.2242649768,180968.9091454483
W01001769,Cardiff 018A,lsoa,617,574,287,287,0,5,1,4,35,26,9,3,93.0,0.8,5.7,317717.7562848745,180513.37820103212
W01001731,Cardiff 008B,lsoa,534,468,244,224,1,2,0,2,55,50,5,8,87.6,0.4,10.3,318638.2345261434,181084.84642271526
W01001736,Cardiff 008C,lsoa,601,554,327,227,0,3,1,2,36,33,3,8,92.2,0.5,6.0,319343.6434955176,181610.99103171675
W01001946,Cardiff 049C,lsoa,707,198,52,146,5,268,170,98,214,205,9,22,28.0,37.9,30.3,317923.7678766262,174071.87499002845
W01001767,Cardiff 044D,lsoa,691,360,135,225,2,112,60,52,208,194,14,9,52.1,16.2,30.1,317501.3183257516,175247.02123918198
W01001766,Cardiff 044C,lsoa,685,379,161,218,0,100,36,64,186,171,15,20,55.3,14.6,27.2,317493.494488932,175556.80659604576
W01001764,Cardiff 044A,lsoa,603,290,135,155,3,143,26,117,156,146,10,11,48.1,23.7,25.9,317582.16521547025,175608.81513239193
W01001855,Cardiff 042A,lsoa,685,300,124,176,2,199,38,161,173,156,17,11,43.8,29.1,25.3,317192.6824188151,176163.8731885365
W01001857,Cardiff 042C,lsoa,843,280,126,154,5,319,154,165,217,206,11,22,33.2,37.8,25.7,317086.3042044775,176298.3240899503
W01001856,Cardiff 042B,lsoa,776,223,109,114,5,196,73,123,327,310,17,25,28.7,25.3,42.1,317643.1085447294,176156.11702926556
W01001862,Cardiff 042D,lsoa,707,247,133,114,3,81,12,69,364,353,11,12,34.9,11.5,51.5,317497.8520257142,176378.67708085806
W01001721,Cardiff 032A,lsoa,594,103,66,37,3,119,53,66,362,328,34,7,17.3,20.0,60.9,317751.8346860609,177680.40022308216
W01001719,Cardiff 028B,lsoa,534,278,161,117,3,10,3,7,238,212,26,5,52.1,1.9,44.6,317707.5465713019,178062.46691481525
W01001939,Cardiff 032F,lsoa,627,147,66,81,1,13,2,11,438,407,31,28,23.4,2.1,69.9,317959.04553788126,176992.19724434696
W01001755,Cardiff 025A,lsoa,536,277,109,168,7,12,5,7,231,213,18,9,51.7,2.2,43.1,317455.84062947636,178602.61523126415
W01001758,Cardiff 025D,lsoa,652,327,155,172,5,16,5,11,293,261,32,11,50.2,2.5,44.9,317672.3119235572,178795.10386031188
W01001771,Cardiff 018C,lsoa,688,562,278,284,1,33,8,25,87,82,5,5,81.7,4.8,12.6,317163.0500403451,180498.7621005363
W01001793,Cardiff 002A,lsoa,567,444,140,304,14,13,1,12,94,90,4,2,78.3,2.3,16.6,317204.3921053238,183268.24817401677
W01001657,Newport 020C,lsoa,547,489,186,303,0,5,2,3,45,41,4,8,89.4,0.9,8.2,324419.52194464067,183719.67563788543
W01001804,Cardiff 015B,lsoa,643,386,140,246,1,187,175,12,54,42,12,15,60.0,29.1,8.4,321906.340127758,181006.294551031
W01001881,Cardiff 013C,lsoa,645,307,128,179,2,249,185,64,71,62,9,16,47.6,38.6,11.0,323170.7502957466,181225.0387263099
W01001877,Cardiff 011A,lsoa,721,573,173,400,3,25,1,24,118,108,10,2,79.5,3.5,16.4,324244.8131614613,181793.53931799452
W01001850,Cardiff 012C,lsoa,790,729,437,292,2,3,2,1,51,45,6,5,92.3,0.4,6.5,316035.1582275457,181230.596810674
W01001853,Cardiff 004C,lsoa,749,681,485,196,3,3,0,3,57,51,6,5,90.9,0.4,7.6,316279.8461891827,181969.2150797473
W01001777,Cardiff 001A,lsoa,610,539,336,203,3,9,7,2,46,40,6,13,88.4,1.5,7.5,319337.92751694005,183640.3645755297
W01001791,Cardiff 005A,lsoa,734,553,328,225,2,52,29,23,112,104,8,15,75.3,7.1,15.3,318102.51964988816,181632.0540125292
W01001800,Cardiff 005D,lsoa,665,390,166,224,3,208,178,30,53,46,7,11,58.6,31.3,8.0,317162.57298363885,181986.40628148016
W01001807,Cardiff 007B,lsoa,591,262,92,170,0,266,243,23,51,47,4,12,44.3,45.0,8.6,322342.940489826,181575.02323656206
W01001817,Cardiff 009C,lsoa,553,395,139,256,3,100,13,87,54,46,8,1,71.4,18.1,9.8,320423.52828593267,181673.08619875583
W01001818,Cardiff 009D,lsoa,625,430,138,292,0,68,9,59,126,113,13,1,68.8,10.9,20.2,320043.4613611992,181145.3391710907
W01001866,Cardiff 016A,lsoa,606,376,179,197,1,159,113,46,48,40,8,22,62.0,26.2,7.9,322470.2455168427,180312.5949478231
W01001942,Cardiff 049B,lsoa,647,224,81,143,5,197,89,108,208,197,11,13,34.6,30.4,32.1,318680.23802730435,174353.2877318564
W01001699,Cardiff 049A,lsoa,1000,220,81,139,6,479,426,53,264,255,9,31,22.0,47.9,26.4,318821.4680035169,175198.95932243238
W01001943,Cardiff 048B,lsoa,635,205,63,142,13,54,4,50,353,333,20,10,32.3,8.5,55.6,319367.61875445826,174252.94632396128
W01001695,Cardiff 036B,lsoa,845,122,39,83,5,360,40,320,348,331,17,10,14.4,42.6,41.2,319088.4934366188,176469.0504381284
W01001725,Cardiff 032D,lsoa,589,55,31,24,2,47,13,34,482,430,52,3,9.3,8.0,81.8,318393.52747568086,177462.91366299207
W01001696,Cardiff 036C,lsoa,683,212,83,129,3,285,66,219,174,154,20,9,31.0,41.7,25.5,319599.03227099474,176662.81589639283
W01001873,Cardiff 038C,lsoa,778,322,118,204,1,242,28,214,201,186,15,12,41.4,31.1,25.8,320240.0456751109,176302.31563340029
W01001940,Cardiff 048A,lsoa,728,185,56,129,18,89,2,87,432,416,16,4,25.4,12.2,59.3,320840.1159405423,170171.2741243602
W01001724,Cardiff 032C,lsoa,549,95,65,30,3,7,2,5,443,425,18,1,17.3,1.3,80.7,318454.44448994705,177698.31900120882
W01001834,Cardiff 033E,lsoa,691,299,122,177,4,83,37,46,289,261,28,16,43.3,12.0,41.8,319165.5683926723,177402.9527176996
W01001837,Cardiff 030C,lsoa,510,170,84,86,6,84,56,28,238,225,13,12,33.3,16.5,46.7,318613.9925419682,178056.5496738754
W01001838,Cardiff 030D,lsoa,640,288,116,172,2,8,4,4,333,313,20,9,45.0,1.3,52.0,318907.83098576986,178138.9926440862
W01001824,Cardiff 029C,lsoa,693,284,115,169,2,39,3,36,364,356,8,4,41.0,5.6,52.5,319543.0630475395,178067.64444148415
W01001836,Cardiff 030B,lsoa,580,218,84,134,2,28,4,24,330,318,12,2,37.6,4.8,56.9,318867.4661743203,178516.37575919623
W01001827,Cardiff 024C,lsoa,619,548,304,244,3,20,3,17,43,40,3,5,88.5,3.2,6.9,318975.825547368,178945.80566067444
W01001826,Cardiff 024B,lsoa,561,500,304,196,2,7,1,6,49,45,4,3,89.1,1.2,8.7,319785.431861158,179167.4779013404
W01001735,Cardiff 019D,lsoa,608,496,264,232,0,8,7,1,102,98,4,2,81.6,1.3,16.8,318905.6899211286,179482.71487842116
W01001734,Cardiff 019C,lsoa,592,530,291,239,2,1,0,1,55,52,3,4,89.5,0.2,9.3,318543.08697962447,179947.09941995243
W01001730,Cardiff 008A,lsoa,647,590,383,207,0,3,1,2,48,44,4,6,91.2,0.5,7.4,319460.37286219024,181247.3520239153
W01001821,Cardiff 024A,lsoa,548,372,204,168,3,68,3,65,98,89,9,7,67.9,12.4,17.9,319420.27402219706,178790.87696379024
W01001822,Cardiff 029A,lsoa,739,508,248,260,1,123,0,123,98,88,10,9,68.7,16.6,13.3,320244.45958699763,178597.5615082683
W01001830,Cardiff 033B,lsoa,883,147,67,80,1,88,13,75,638,617,21,9,16.6,10.0,72.3,319430.4999655485,177677.16418478233
W01001831,Cardiff 030A,lsoa,620,296,135,161,4,14,7,7,295,275,20,11,47.7,2.3,47.6,319096.2981668002,177854.14989938098
W01001833,Cardiff 033D,lsoa,716,326,153,173,3,73,9,64,311,298,13,3,45.5,10.2,43.4,319601.6653796944,177465.28581049727
W01001839,Cardiff 030E,lsoa,613,257,133,124,4,26,6,20,319,297,22,7,41.9,4.2,52.0,318790.03551185026,177964.00895640886
W01001950,Cardiff 049D,lsoa,609,240,80,160,2,40,12,28,318,303,15,9,39.4,6.6,52.2,318674.791467382,174667.09503117754
W01001947,Cardiff 048E,lsoa,873,352,70,282,10,39,10,29,466,444,22,6,40.3,4.5,53.4,317400.404438332,173925.86397937877
W01001759,Cardiff 046A,lsoa,674,500,181,319,5,44,11,33,120,109,11,5,74.2,6.5,17.8,316891.40014007414,175003.18110787324
W01001713,Cardiff 040E,lsoa,745,481,190,291,2,92,8,84,162,143,19,8,64.6,12.3,21.7,316483.12672888965,176324.2291716176
W01001859,Cardiff 034B,lsoa,722,380,164,216,2,68,6,62,268,262,6,4,52.6,9.4,37.1,316547.742259611,177109.56821300284
W01001860,Cardiff 034C,lsoa,799,475,191,284,1,46,19,27,264,253,11,13,59.4,5.8,33.0,316790.3185768131,176928.03382810196
W01001861,Cardiff 034D,lsoa,757,362,139,223,0,33,4,29,350,336,14,12,47.8,4.4,46.2,317129.72179127263,176884.26572416365
W01001756,Cardiff 025B,lsoa,667,308,124,184,2,196,138,58,143,98,45,18,46.2,29.4,21.4,316766.79696796706,178571.78873361496
W01001775,Cardiff 021B,lsoa,693,502,244,258,1,38,26,12,142,128,14,10,72.4,5.5,20.5,316660.04879032506,179913.64342130127
W01001090,The Vale of Glamorgan 006E,lsoa,615,562,299,263,1,15,10,5,31,26,5,6,91.4,2.4,5.0,314678.5557522886,173662.45416294332
W01001136,The Vale of Glamorgan 003D,lsoa,497,460,267,193,0,6,6,0,28,23,5,3,92.6,1.2,5.6,312275.9931946142,173573.85666905003
W01001702,Cardiff 045A,lsoa,745,466,164,302,1,172,69,103,100,79,21,6,62.6,23.1,13.4,312454.8874025063,175197.98362188056
W01001703,Cardiff 045B,lsoa,503,233,106,127,1,218,107,111,43,36,7,8,46.3,43.3,8.5,313619.91002401186,175448.7016810575
W01001704,Cardiff 041A,lsoa,631,226,98,128,0,341,288,53,48,45,3,16,35.8,54.0,7.6,314203.69566166366,175736.16600198878
W01001705,Cardiff 045C,lsoa,718,430,149,281,4,170,123,47,105,98,7,9,59.9,23.7,14.6,313192.29993507476,175061.4495257406
W01001707,Cardiff 041C,lsoa,803,374,124,250,2,352,173,179,64,51,13,11,46.6,43.8,8.0,314400.34758990904,176099.60095792744
W01001708,Cardiff 045D,lsoa,737,308,126,182,1,332,220,112,83,75,8,13,41.8,45.0,11.3,313265.80187259975,175666.27974167408
W01001729,Cardiff 014C,lsoa,808,684,235,449,1,15,4,11,101,96,5,7,84.7,1.9,12.5,311261.2108390088,178244.96636687982
W01001737,Cardiff 039A,lsoa,653,242,94,148,1,354,343,11,47,41,6,9,37.1,54.2,7.2,313566.26062761375,176743.79068926044
W01001738,Cardiff 039B,lsoa,525,177,68,109,1,283,273,10,53,50,3,11,33.7,53.9,10.1,312772.83513914765,176504.02219772377
W01001739,Cardiff 039C,lsoa,523,165,56,109,1,298,268,30,52,49,3,7,31.5,57.0,9.9,313369.2338952302,176608.50256715194
W01001740,Cardiff 039D,lsoa,682,271,113,158,1,352,335,17,49,46,3,9,39.7,51.6,7.2,313471.930983525,176228.22101168704
W01001741,Cardiff 039E,lsoa,613,157,53,104,0,395,377,18,47,42,5,14,25.6,64.4,7.7,312917.04152730864,176271.20253904903
W01001742,Cardiff 043A,lsoa,640,238,95,143,0,340,302,38,50,47,3,12,37.2,53.1,7.8,312940.40706147917,175889.1365594347
W01001743,Cardiff 043B,lsoa,605,525,245,280,6,26,22,4,43,34,9,5,86.8,4.3,7.1,311709.0505502423,175840.0319245293
W01001744,Cardiff 043C,lsoa,740,265,102,163,0,396,316,80,54,42,12,25,35.8,53.5,7.3,312381.69325076987,175578.25205297623
W01001749,Cardiff 027C,lsoa,699,433,182,251,4,186,131,55,66,54,12,10,61.9,26.6,9.4,313122.5527051976,178352.51345160653
W01001750,Cardiff 031A,lsoa,841,384,173,211,1,356,296,60,71,61,10,29,45.7,42.3,8.4,314000.4118670318,177862.20617758943
W01001751,Cardiff 027D,lsoa,802,356,140,216,5,349,332,17,77,67,10,15,44.4,43.5,9.6,313216.22406872484,177845.20650267845
W01001752,Cardiff 031B,lsoa,673,572,277,295,0,32,29,3,59,51,8,10,85.0,4.8,8.8,313913.06671285816,177294.4945193673
W01001846,Cardiff 006C,lsoa,641,539,192,347,0,32,17,15,67,58,9,3,84.1,5.0,10.5,312307.815517958,181466.88713225466
W01001847,Cardiff 006D,lsoa,637,614,377,237,0,2,1,1,16,16,0,5,96.4,0.3,2.5,312383.6472321325,181414.63301234398
W01001954,Cardiff 006F,lsoa,637,558,323,235,3,19,5,14,49,44,5,8,87.6,3.0,7.7,312958.36679349584,180611.47056471003
W01001780,Cardiff 026B,lsoa,628,512,260,252,4,39,1,38,69,67,2,4,81.5,6.2,11.0,314565.79498923966,178738.0099611766
W01001745,Cardiff 043D,lsoa,556,493,232,261,0,17,12,5,41,33,8,5,88.7,3.1,7.4,311587.4465580335,175327.12050324917
W01001746,Cardiff 041D,lsoa,663,303,116,187,1,253,233,20,96,84,12,10,45.7,38.2,14.5,314086.314019939,176739.10356448984
W01001747,Cardiff 027A,lsoa,812,617,260,357,3,31,25,6,153,144,9,8,76.0,3.8,18.8,313764.52935698634,178595.5809171048
W01001748,Cardiff 027B,lsoa,650,385,157,228,2,178,166,12,70,57,13,15,59.2,27.4,10.8,313858.41718127043,178269.90619607174
W01001753,Cardiff 031C,lsoa,642,299,117,182,1,269,99,170,65,55,10,8,46.6,41.9,10.1,313193.1607484043,177408.89604200737
W01001784,Cardiff 026F,lsoa,585,486,234,252,2,9,2,7,85,77,8,3,83.1,1.5,14.5,314037.3970441571,178850.7015628324
W01001706,Cardiff 041B,lsoa,540,375,189,186,6,90,18,72,59,55,4,10,69.4,16.7,10.9,314850.34847368614,176332.1920359961
W01001754,Cardiff 031D,lsoa,829,621,321,300,6,76,14,62,114,107,7,12,74.9,9.2,13.8,314407.6316338188,177216.97814333433
W01001779,Cardiff 026A,lsoa,653,522,289,233,0,14,2,12,105,92,13,12,79.9,2.1,16.1,314963.95431220985,178005.79136730928
W01001894,Cardiff 010C,lsoa,651,580,311,269,1,14,10,4,51,46,5,5,89.1,2.2,7.8,314666.7007522099,181133.50120941637
W01001849,Cardiff 004A,lsoa,651,591,343,248,0,4,3,1,52,49,3,4,90.8,0.6,8.0,314932.42788160057,182096.143380204
W01001885,Cardiff 011D,lsoa,786,541,129,412,3,134,78,56,101,90,11,7,68.8,17.0,12.8,323688.228414576,179098.22847917143
W01001886,Cardiff 016D,lsoa,516,222,87,135,0,235,103,132,51,45,6,8,43.0,45.5,9.9,323092.72971230675,180027.3394755419
W01001912,Newport 020E,lsoa,648,559,281,278,3,10,4,6,71,62,9,5,86.3,1.5,11.0,327937.5044875044,181929.44324992562
W01001878,Cardiff 011B,lsoa,630,462,152,310,2,87,80,7,73,67,6,6,73.3,13.8,11.6,323767.4310386791,181589.54248731275
W01001419,Caerphilly 021D,lsoa,632,479,222,257,2,85,81,4,53,46,7,13,75.8,13.4,8.4,320260.5280645491,186256.34352958298
W01001778,Cardiff 001B,lsoa,700,666,344,322,0,2,2,0,22,22,0,10,95.1,0.3,3.1,317555.4785893678,183876.7824833268
W00010122,,oa,114,21,8,13,0,12,3,9,79,79,0,2,18.4,10.5,69.3,319804.47750000004,177341.7465
W00010202,,oa,134,52,18,34,0,2,2,0,78,76,2,2,38.8,1.5,58.2,318592.762,174829.783
W00009432,,oa,133,30,12,18,0,4,1,3,98,94,4,1,22.6,3.0,73.7,319558.603,177512.225
W00009131,,oa,131,66,28,38,0,27,1,26,32,31,1,6,50.4,20.6,24.4,317900.23199999996,175504.0745
W00008803,,oa,159,22,7,15,0,102,48,54,32,31,1,3,13.8,64.2,20.1,319005.5,174629.9585
W00010124,,oa,115,17,5,12,1,45,2,43,51,49,2,1,14.8,39.1,44.3,318719.2415,174442.31949999998
W00009091,,oa,124,46,17,29,0,33,4,29,41,37,4,4,37.1,26.6,33.1,317928.00049999997,174498.6485
W00010141,,oa,137,45,24,21,0,1,0,1,85,82,3,6,32.8,0.7,62.0,317927.8985,176329.9285
W00010148,,oa,89,11,2,9,0,48,3,45,27,26,1,3,12.4,53.9,30.3,317940.222,173810.124
W00010171,,oa,130,29,7,22,6,32,2,30,61,60,1,2,22.3,24.6,46.9,319332.493,175172.8205
W00010203,,oa,91,36,15,21,0,26,4,22,27,24,3,2,39.6,28.6,29.7,318670.75450000004,174483.2755
W00008816,,oa,183,8,5,3,0,157,152,5,7,7,0,11,4.4,85.8,3.8,318819,175208.6885
W00010125,,oa,77,7,6,1,0,6,2,4,64,60,4,0,9.1,7.8,83.1,318273.75049999997,177417.102
W00009428,,oa,123,44,20,24,0,16,3,13,62,59,3,1,35.8,13.0,50.4,318965.849,177579.5765
W00010205,,oa,97,76,41,35,1,1,1,0,17,15,2,2,78.4,1.0,17.5,317670.822,177948.62300000002
W00009074,,oa,121,72,39,33,1,2,1,1,44,39,5,2,59.5,1.7,36.4,317816.10199999996,178665.842
W00010193,,oa,132,29,5,24,6,3,2,1,93,92,1,1,22.0,2.3,70.5,318566.6385,174997.1745
W00010118,,oa,96,10,7,3,1,12,7,5,72,65,7,1,10.4,12.5,75.0,317814.2395,177644.718
W00010191,,oa,108,49,16,33,0,1,1,0,57,51,6,1,45.4,0.9,52.8,318830.53500000003,175781.2605
W00010119,,oa,76,8,4,4,0,2,1,1,66,63,3,0,10.5,2.6,86.8,317705.922,177685.229
W00010166,,oa,122,85,7,78,2,7,6,1,25,24,1,3,69.7,5.7,20.5,321230.971,181694.44449999998
W00010167,,oa,105,20,5,15,2,0,0,0,83,77,6,0,19.0,0.0,79.0,318160.7525,173516.7825
W00009335,,oa,138,88,29,59,0,30,17,13,17,15,2,3,63.8,21.7,12.3,320563.3275,181429.106
W00010132,,oa,68,5,3,2,0,16,2,14,47,45,2,0,7.4,23.5,69.1,318597.135,177228.1545
W00008906,,oa,141,28,13,15,2,9,2,7,100,97,3,2,19.9,6.4,70.9,318064.98199999996,177821.062
W00008904,,oa,152,30,21,9,1,2,1,1,118,112,6,1,19.7,1.3,77.6,318475.0195,177776.6775
W00008909,,oa,121,15,9,6,1,1,0,1,104,101,3,0,12.4,0.8,86.0,318365.11100000003,177683.31949999998
W00008902,,oa,177,64,19,45,0,4,1,3,107,101,6,2,36.2,2.3,60.5,318193.2655,178749.8655
W00008901,,oa,134,23,10,13,0,3,1,2,107,106,1,1,17.2,2.2,79.9,318480.9865,177494.16749999998
W00009435,,oa,140,17,7,10,0,18,0,18,103,98,5,2,12.1,12.9,73.6,319448.8155,177551.03499999997
W00008916,,oa,131,18,17,1,3,6,2,4,100,97,3,4,13.7,4.6,76.3,318634.5075,177327.198
W00008912,,oa,145,47,37,10,2,9,6,3,86,68,18,1,32.4,6.2,59.3,317865.8995,177567.52649999998
W00008911,,oa,127,11,6,5,0,41,37,4,71,67,4,4,8.7,32.3,55.9,318138.7685,177597.517
W00008918,,oa,123,36,20,16,0,3,0,3,81,73,8,3,29.3,2.4,65.9,318076.5,178462.426
W00008919,,oa,96,28,14,14,1,16,1,15,49,48,1,2,29.2,16.7,51.0,317740.5995,178399.47100000002
W00009374,,oa,109,96,27,69,0,8,2,6,5,5,0,0,88.1,7.3,4.6,320145.395,181430.0275
W00009307,,oa,131,90,38,52,0,30,26,4,7,7,0,4,68.7,22.9,5.3,321767.80850000004,180372.81900000002
W00009400,,oa,125,65,25,40,0,8,1,7,51,48,3,1,52.0,6.4,40.8,319372.753,178143.06050000002
W00010116,,oa,146,32,9,23,1,7,1,6,106,101,5,0,21.9,4.8,72.6,319083.07999999996,176700.845
W00010195,,oa,102,38,8,30,0,2,0,2,59,55,4,3,37.3,2.0,57.8,318846.5605,175562.375
W00009120,,oa,151,53,23,30,1,64,34,30,20,20,0,13,35.1,42.4,13.2,317793.31649999996,174145.859
W00009121,,oa,209,35,9,26,0,111,107,4,53,52,1,10,16.7,53.1,25.4,317979.074,174198.343
W00009128,,oa,125,100,55,45,0,1,0,1,24,22,2,0,80.0,0.8,19.2,317844.0925,175704.84149999998
W00009392,,oa,142,71,30,41,2,6,0,6,63,62,1,0,50.0,4.2,44.4,319288.447,178459.137
W00009318,,oa,127,40,16,24,1,74,67,7,10,9,1,2,31.5,58.3,7.9,321956.8995,181568.788
W00009399,,oa,128,99,36,63,0,2,0,2,27,26,1,0,77.3,1.6,21.1,319712.995,178128.9905
W00009398,,oa,130,23,7,16,1,7,0,7,99,99,0,0,17.7,5.4,76.2,319356.042,178027.7115
W00009419,,oa,133,108,66,42,0,0,0,0,24,23,1,1,81.2,0.0,18.0,319795.8615,178807.0085
W00008960,,oa,139,127,77,50,0,0,0,0,10,10,0,2,91.4,0.0,7.2,318756.1425,180755.4365
W00008801,,oa,140,85,34,51,0,14,3,11,39,35,4,2,60.7,10.0,27.9,320164.42350000003,177184.975
W00009117,,oa,172,65,23,42,3,61,36,25,35,34,1,8,37.8,35.5,20.3,317714.3225,174524.8725
W00009474,,oa,120,86,27,59,1,3,2,1,30,30,0,0,71.7,2.5,25.0,319581.952,177678.0565
W00009473,,oa,148,80,34,46,3,3,2,1,60,54,6,2,54.1,2.0,40.5,319115.6655,177723.0935
W00009642,,oa,123,70,33,37,1,25,2,23,24,23,1,3,56.9,20.3,19.5,320200.1015,176480.581
W00008974,,oa,108,105,57,48,0,0,0,0,3,3,0,0,97.2,0.0,2.8,318891.802,179773.845
W00009641,,oa,105,63,17,46,0,28,25,3,13,10,3,1,60.0,26.7,12.4,320651.44,176729.62550000002
W00009106,,oa,120,61,21,40,1,24,11,13,28,25,3,6,50.8,20.0,23.3,317894.2265,175004.015
W00009107,,oa,127,41,12,29,0,49,2,47,35,33,2,2,32.3,38.6,27.6,317636.60349999997,174864.7955
W00009108,,oa,141,48,22,26,0,52,32,20,31,30,1,10,34.0,36.9,22.0,317904.719,174739.9455
W00009362,,oa,122,85,45,40,3,27,21,6,6,4,2,1,69.7,22.1,4.9,319959.657,179815.397
W00008811,,oa,140,66,14,52,1,5,3,2,65,62,3,3,47.1,3.6,46.4,319033.315,175765.46399999998
W00009557,,oa,161,52,26,26,0,28,5,23,79,79,0,2,32.3,17.4,49.1,317662.0785,176223.4165
W00009467,,oa,124,55,20,35,0,3,2,1,63,57,6,3,44.4,2.4,50.8,319058.8465,177992.548
W00009464,,oa,121,62,32,30,3,2,1,1,53,51,2,1,51.2,1.7,43.8,318815.9265,177946.8655
W00009460,,oa,130,65,20,45,1,0,0,0,62,56,6,2,50.0,0.0,47.7,318937.61699999997,178156.6615
W00009654,,oa,133,58,20,38,0,58,54,4,14,11,3,3,43.6,43.6,10.5,320629.19499999995,177160.46600000001
W00009112,,oa,191,61,32,29,1,34,6,28,89,87,2,6,31.9,17.8,46.6,317624.5455,174851
W00009114,,oa,207,127,70,57,0,21,1,20,52,48,4,7,61.4,10.1,25.1,318263.359,174561.179
W00009113,,oa,124,78,27,51,0,12,1,11,32,29,3,2,62.9,9.7,25.8,317980.4445,174663.588
W00009118,,oa,170,20,9,11,0,79,44,35,65,64,1,6,11.8,46.5,38.2,317776.2485,174443.061
W00009119,,oa,165,44,14,30,3,66,34,32,49,46,3,3,26.7,40.0,29.7,318044.26399999997,173977.398
W00009609,,oa,141,83,35,48,0,44,21,23,12,11,1,2,58.9,31.2,8.5,322188.681,178718.08899999998
W00010123,,oa,69,62,35,27,1,0,0,0,5,5,0,1,89.9,0.0,7.2,319507.4965,179746.0615
W00010121,,oa,130,24,13,11,0,3,0,3,101,94,7,2,18.5,2.3,77.7,318246.1275,176254.737
W00009627,,oa,118,114,60,54,0,0,0,0,2,2,0,2,96.6,0.0,1.7,321743.3905,179426.749
W00009984,,oa,160,27,11,16,0,71,8,63,59,57,2,3,16.9,44.4,36.9,319262.71499999997,176736.929
W00009341,,oa,117,80,16,64,0,11,1,10,25,24,1,1,68.4,9.4,21.4,320319.206,181107.7555
W00009440,,oa,138,67,23,44,0,21,9,12,48,45,3,2,48.6,15.2,34.8,319268.06700000004,177349.472
W00009632,,oa,125,85,35,50,0,18,3,15,19,15,4,3,68.0,14.4,15.2,320260.373,176769.413
W00009631,,oa,114,51,17,34,1,45,40,5,15,14,1,2,44.7,39.5,13.2,320874.8935,176699.8835
W00009638,,oa,115,51,27,24,0,48,38,10,13,11,2,3,44.3,41.7,11.3,320957.0125,176577.831
W00009160,,oa,121,116,52,64,0,1,0,1,4,3,1,0,95.9,0.8,3.3,317770.12,180564.54499999998
W00008924,,oa,152,34,18,16,3,4,1,3,107,102,5,4,22.4,2.6,70.4,318227.91099999996,178183.177
W00008929,,oa,133,33,19,14,0,2,0,2,97,91,6,1,24.8,1.5,72.9,318173.174,178099.059
W00009356,,oa,144,123,56,67,1,8,5,3,12,10,2,0,85.4,5.6,8.3,319574.659,180154.6255
W00009455,,oa,119,21,7,14,1,66,53,13,27,24,3,4,17.6,55.5,22.7,318581.8165,178077.2735
W00009450,,oa,114,37,28,9,2,70,15,55,4,4,0,1,32.5,61.4,3.5,319235.77150000003,176953
W00008785,,oa,170,76,29,47,0,17,1,16,71,64,7,6,44.7,10.0,41.8,319691.228,176809.391
W00008789,,oa,139,38,14,24,0,66,2,64,35,28,7,0,27.3,47.5,25.2,319482.13899999997,176598.0275
W00009606,,oa,119,101,49,52,0,2,2,0,14,8,6,2,84.9,1.7,11.8,321215.6925,179093.91950000002
W00010129,,oa,92,33,7,26,0,0,0,0,59,55,4,0,35.9,0.0,64.1,319229.757,175491.691
W00008932,,oa,157,35,18,17,1,6,1,5,113,113,0,2,22.3,3.8,72.0,318142.033,177940.1325
W00009093,,oa,201,82,13,69,1,4,0,4,110,103,7,4,40.8,2.0,54.7,318051.224,173612.9965
W00009098,,oa,128,67,32,35,0,12,0,12,45,42,3,4,52.3,9.4,35.2,317847.2745,175203.9425
W00009427,,oa,128,117,60,57,0,0,0,0,10,8,2,1,91.4,0.0,7.8,319767.9115,177610.9205
W00009424,,oa,143,37,18,19,2,7,0,7,95,87,8,2,25.9,4.9,66.4,318905.2555,177285.9235
W00009422,,oa,123,116,78,38,1,1,0,1,4,4,0,1,94.3,0.8,3.3,319912.212,178582.8505
W00009420,,oa,131,124,60,64,0,2,2,0,4,3,1,1,94.7,1.5,3.1,320457.19649999996,178948.84975
W00009421,,oa,132,92,65,27,1,23,1,22,14,10,4,2,69.7,17.4,10.6,319347.8135,178687.4925
W00008797,,oa,176,91,36,55,0,37,3,34,44,39,5,4,51.7,21.0,25.0,320497.96349999995,177617.451
W00008791,,oa,111,23,9,14,1,73,39,34,12,10,2,2,20.7,65.8,10.8,319587.2295,176478.22149999999
W00009569,,oa,125,57,19,38,0,39,24,15,26,24,2,3,45.6,31.2,20.8,317088.79949999996,176181.4745
W00008896,,oa,118,68,27,41,0,4,0,4,44,44,0,2,57.6,3.4,37.3,315959.7865,177014.9265
W00009724,,oa,134,115,61,54,0,7,5,2,12,11,1,0,85.8,5.2,9.0,315178.78599999996,179596.3895
W00009127,,oa,137,77,28,49,0,25,1,24,33,31,2,2,56.2,18.2,24.1,317537.92850000004,175614.0095
W00008855,,oa,121,78,36,42,0,6,0,6,35,34,1,2,64.5,5.0,28.9,316310.45900000003,176954.4705
W00008859,,oa,123,68,29,39,1,3,0,3,48,43,5,3,55.3,2.4,39.0,315641.50450000004,176764.2915
W00009248,,oa,124,107,49,58,0,3,1,2,12,12,0,2,86.3,2.4,9.7,316811.1235,182740.8765
W00009154,,oa,138,113,64,49,0,1,0,1,21,17,4,3,81.9,0.7,15.2,317843.368,179264.5755
W00009155,,oa,119,60,35,25,0,26,25,1,30,26,4,3,50.4,21.8,25.2,318140.3945,179648.4365
W00009568,,oa,144,26,13,13,0,30,2,28,87,84,3,1,18.1,20.8,60.4,317529.7245,176188.3785
W00009754,,oa,125,60,29,31,0,43,42,1,19,17,2,3,48.0,34.4,15.2,315706.078,180038.7885
W00009402,,oa,115,104,50,54,0,3,1,2,8,6,2,0,90.4,2.6,7.0,319959.374,177998.1245
W00009756,,oa,129,65,35,30,0,34,4,30,29,27,2,1,50.4,26.4,22.5,315558.72849999997,180177.934
W00009755,,oa,123,92,48,44,0,2,2,0,28,26,2,1,74.8,1.6,22.8,315310.301,180200.2795
W00009750,,oa,130,108,67,41,0,1,0,1,19,17,2,2,83.1,0.8,14.6,315835.61199999996,180273.05599999998
W00009759,,oa,125,73,35,38,0,19,16,3,26,25,1,7,58.4,15.2,20.8,315465.45849999995,179888.445
W00009226,,oa,121,86,38,48,3,22,19,3,9,9,0,1,71.1,18.2,7.4,315263.484,179239.324
W00009575,,oa,142,10,4,6,2,84,54,30,40,35,5,6,7.0,59.2,28.2,317686.431,175921.2175
W00009571,,oa,144,52,26,26,0,47,2,45,42,39,3,3,36.1,32.6,29.2,317183.38800000004,176075.687
W00009725,,oa,124,115,57,58,0,3,3,0,5,5,0,1,92.7,2.4,4.0,315424.3715,180564.2665
W00009722,,oa,122,107,51,56,0,0,0,0,13,12,1,2,87.7,0.0,10.7,314960.6135,180323.7955
W00008887,,oa,157,84,35,49,0,9,1,8,64,63,1,0,53.5,5.7,40.8,315813.945,177313.0425
W00008884,,oa,122,34,10,24,0,70,69,1,18,17,1,0,27.9,57.4,14.8,316107.5065,175500.59000000003
W00008883,,oa,136,105,74,31,0,12,11,1,15,15,0,4,77.2,8.8,11.0,316255.3155,175960.522
W00008889,,oa,131,96,29,67,0,24,1,23,11,11,0,0,73.3,18.3,8.4,315969.76300000004,177174.43349999998
W00008888,,oa,127,71,51,20,0,38,1,37,15,13,2,3,55.9,29.9,11.8,316148.62600000005,177186.86599999998
W00009197,,oa,196,116,86,30,0,4,0,4,60,57,3,16,59.2,2.0,30.6,315514.5415,178034.0145
W00009116,,oa,119,72,21,51,0,10,6,4,36,30,6,1,60.5,8.4,30.3,317968.2735,174611.3295
W00009195,,oa,136,98,62,36,0,1,0,1,32,30,2,5,72.1,0.7,23.5,315085.8175,178154.541
W00009231,,oa,117,34,18,16,1,72,34,38,9,9,0,1,29.1,61.5,7.7,315647.2825,179008.6605
W00009548,,oa,100,88,48,40,0,3,2,1,8,5,3,1,88.0,3.0,8.0,315517.6155,180739.039
W00009737,,oa,124,121,83,38,0,0,0,0,3,3,0,0,97.6,0.0,2.4,315822.819,179416.6405
W00009640,,oa,139,73,28,45,0,36,5,31,29,25,4,1,52.5,25.9,20.9,319909.07999999996,176537.718
W00008978,,oa,99,89,51,38,0,1,1,0,5,4,1,4,89.9,1.0,5.1,319467.00950000004,182089.7905
W00009186,,oa,105,104,58,46,0,0,0,0,1,1,0,0,99.0,0.0,1.0,314914.2605,177821.2765
W00009100,,oa,132,94,25,69,2,9,1,8,27,24,3,0,71.2,6.8,20.5,316892.024,174750.691
W00008814,,oa,154,45,29,16,1,93,79,14,12,11,1,3,29.2,60.4,7.8,318759.4105,175466.6385
W00008894,,oa,132,111,54,57,0,0,0,0,17,16,1,4,84.1,0.0,12.9,315091.4075,177093.565
W00008893,,oa,148,118,58,60,0,5,3,2,23,22,1,2,79.7,3.4,15.5,314882.983,177004.29700000002
W00009286,,oa,127,107,66,41,0,1,0,1,15,12,3,4,84.3,0.8,11.8,317562.52150000003,181994.959
W00009204,,oa,126,59,30,29,0,35,1,34,27,24,3,5,46.8,27.8,21.4,316062.64300000004,177480.501
W00009205,,oa,129,120,69,51,0,0,0,0,9,9,0,0,93.0,0.0,7.0,315115.8055,177353.75
W00009203,,oa,109,64,34,30,0,7,0,7,37,35,2,1,58.7,6.4,33.9,315261.73199999996,177483.3245
W00009201,,oa,122,112,56,56,0,1,1,0,7,7,0,2,91.8,0.8,5.7,314834.6625,177438.3895
W00009552,,oa,126,113,79,34,0,1,1,0,12,11,1,0,89.7,0.8,9.5,316094.993,180672.699
W00009550,,oa,116,111,77,34,0,0,0,0,5,5,0,0,95.7,0.0,4.3,316020.0815,180815.6925
W00009559,,oa,137,64,26,38,0,35,8,27,35,33,2,3,46.7,25.5,25.5,316921.839,176205.69400000002
W00009468,,oa,178,53,28,25,1,8,0,8,112,106,6,4,29.8,4.5,62.9,318654.2485,177827.495
W00010177,,oa,194,48,7,41,7,90,5,85,47,45,2,2,24.7,46.4,24.2,316978.412,181051.059
W00009199,,oa,121,115,63,52,1,2,1,1,2,1,1,1,95.0,1.7,1.7,314969.4135,177642.776
W00009198,,oa,150,138,70,68,0,2,1,1,9,9,0,1,92.0,1.3,6.0,315643.6355,177572.326
W00009214,,oa,113,38,17,21,1,72,7,65,2,2,0,0,33.6,63.7,1.8,315798.9485,179174.84149999998
W00009218,,oa,116,89,32,57,0,18,11,7,8,7,1,1,76.7,15.5,6.9,315352.002,178619.7045
W00009527,,oa,126,116,58,58,0,1,1,0,7,7,0,2,92.1,0.8,5.6,315339.645,181772.533
W00010126,,oa,43,30,12,18,0,6,6,0,5,3,2,2,69.8,14.0,11.6,316687.22400000005,178484.37050000002
W00009983,,oa,95,15,7,8,1,28,0,28,46,45,1,5,15.8,29.5,48.4,317582.77099999995,175608.752
W00008864,,oa,138,96,42,54,1,10,2,8,30,26,4,1,69.6,7.2,21.7,316494.88300000003,176772.56300000002
W00008870,,oa,134,107,47,60,0,1,1,0,24,18,6,2,79.9,0.7,17.9,315507.8715,176615.9205
W00009537,,oa,110,63,29,34,2,37,9,28,7,7,0,1,57.3,33.6,6.4,315501.82550000004,181267.1825
W00009535,,oa,143,135,107,28,0,0,0,0,5,4,1,3,94.4,0.0,3.5,316391.8895,181723.874
W00009587,,oa,116,71,31,40,0,2,0,2,43,40,3,0,61.2,1.7,37.1,316763.8275,177193.5195
W00009762,,oa,119,113,61,52,0,0,0,0,6,6,0,0,95.0,0.0,5.0,314904.8815,179787.0895
W00009170,,oa,117,110,62,48,0,1,0,1,4,3,1,2,94.0,0.9,3.4,317744.17449999996,180249.00400000002
W00008931,,oa,117,32,24,8,0,4,1,3,80,78,2,1,27.4,3.4,68.4,317914.788,178051.276
W00008794,,oa,189,42,19,23,1,7,2,5,131,128,3,8,22.2,3.7,69.3,319937.177,177469.152
W00005833,,oa,127,114,49,65,0,3,2,1,10,9,1,0,89.8,2.4,7.9,316492.04949999996,173481.869
W00005831,,oa,131,94,29,65,0,13,7,6,24,19,5,0,71.8,9.9,18.3,316398.51300000004,173011.8045
W00005835,,oa,122,107,62,45,0,1,0,1,14,10,4,0,87.7,0.8,11.5,317131.15449999995,173229.195
W00008897,,oa,113,80,36,44,1,5,1,4,26,24,2,1,70.8,4.4,23.0,315829.221,177097.15149999998
W00009224,,oa,136,75,40,35,0,53,47,6,7,6,1,1,55.1,39.0,5.1,315909.9565,178448.6445
W00009222,,oa,121,17,5,12,1,87,86,1,12,11,1,4,14.0,71.9,9.9,315872.13899999997,178661.4995
W00008863,,oa,120,92,41,51,1,2,2,0,24,19,5,1,76.7,1.7,20.0,316185.483,176753.2415
W00009077,,oa,133,83,40,43,2,2,0,2,43,41,2,3,62.4,1.5,32.3,317327.2115,178699.91950000002
W00009613,,oa,128,89,40,49,0,31,3,28,8,8,0,0,69.5,24.2,6.3,322234.07550000004,178074.809
W00009610,,oa,126,110,49,61,0,6,2,4,9,8,1,1,87.3,4.8,7.1,321102.7975,178816.793
W00010232,,oa,45,30,19,11,0,0,0,0,13,11,2,2,66.7,0.0,28.9,317485.245,178177.4515
W00008856,,oa,119,93,34,59,0,12,2,10,12,11,1,2,78.2,10.1,10.1,315685.123,176978
W00009244,,oa,117,91,29,62,11,4,0,4,10,9,1,1,77.8,3.4,8.5,316995.1235,183233.1515
W00009243,,oa,129,119,44,75,0,0,0,0,10,9,1,0,92.2,0.0,7.8,317339.947,183206.9995
W00009563,,oa,139,64,38,26,0,11,3,8,63,61,2,1,46.0,7.9,45.3,317641.13049999997,176377.235
W00009309,,oa,128,78,36,42,0,42,33,9,6,4,2,2,60.9,32.8,4.7,321942.878,180195.8115
W00009566,,oa,121,65,32,33,0,13,2,11,40,37,3,3,53.7,10.7,33.1,317355.2695,176275.62949999998
W00009567,,oa,114,42,21,21,2,30,5,25,38,38,0,2,36.8,26.3,33.3,316982.0595,176067.948
W00009564,,oa,127,70,27,43,1,28,0,28,28,24,4,0,55.1,22.0,22.0,317008.5405,176263.574
W00010115,,oa,68,10,7,3,0,4,0,4,53,51,2,1,14.7,5.9,77.9,318442.2595,177125.75
W00009314,,oa,136,74,34,40,0,33,2,31,25,23,2,4,54.4,24.3,18.4,321097.84550000005,179400.3135
W00010215,,oa,131,50,10,40,0,6,0,6,75,72,3,0,38.2,4.6,57.3,319072.1115,175224.391
W00010213,,oa,64,54,24,30,0,6,1,5,4,3,1,0,84.4,9.4,6.3,316109.55299999996,176291.327
W00009223,,oa,114,74,28,46,0,26,25,1,11,8,3,3,64.9,22.8,9.6,316139.91949999996,178436.476
W00009576,,oa,125,35,15,20,0,68,4,64,19,17,2,3,28.0,54.4,15.2,316453.1095,177802.31449999998
W00009579,,oa,129,89,59,30,4,6,1,5,28,26,2,2,69.0,4.7,21.7,316567.775,177242.803
W00008966,,oa,109,103,59,44,0,0,0,0,6,6,0,0,94.5,0.0,5.5,318334.0165,180127.7065
W00009137,,oa,119,81,38,43,0,5,3,2,33,31,2,0,68.1,4.2,27.7,317469.5325,175381.889
W00009134,,oa,129,74,30,44,0,15,11,4,36,33,3,4,57.4,11.6,27.9,317313.40150000004,175444.864
W00009130,,oa,137,61,23,38,0,32,15,17,38,34,4,6,44.5,23.4,27.7,317410.7215,175560.18949999998
W00009139,,oa,121,111,62,49,0,1,0,1,9,5,4,0,91.7,0.8,7.4,317213.3995,179454.122
W00008885,,oa,192,94,28,66,0,56,40,16,32,28,4,10,49.0,29.2,16.7,316766.7785,175765.7525
W00009545,,oa,121,115,55,60,0,1,0,1,4,2,2,1,95.0,0.8,3.3,315820.94350000005,180958.152
W00009541,,oa,114,100,58,42,0,0,0,0,13,10,3,1,87.7,0.0,11.4,315927.7925,181267.7745
W00009730,,oa,124,104,71,33,0,0,0,0,19,18,1,1,83.9,0.0,15.3,316043.05299999996,179721.33500000002
W00010162,,oa,114,84,32,52,2,15,10,5,10,10,0,3,73.7,13.2,8.8,316946.25899999996,180409.0505
W00009101,,oa,138,76,36,40,0,11,4,7,44,40,4,7,55.1,8.0,31.9,317864.9045,175108.438
W00009289,,oa,129,81,35,46,2,36,24,12,8,8,0,2,62.8,27.9,6.2,317139.77749999997,182008.352
W00009554,,oa,112,104,64,40,1,0,0,0,7,7,0,0,92.9,0.0,6.3,316310.5695,182311.538
W00009115,,oa,107,66,27,39,0,29,3,26,12,11,1,0,61.7,27.1,11.2,318356.774,174684.973
W00010140,,oa,152,104,30,74,0,28,1,27,17,15,2,3,68.4,18.4,11.2,315786.78599999996,176105.634
W00010120,,oa,210,55,8,47,17,80,1,79,57,57,0,1,26.2,38.1,27.1,319517.217,174681.0815
W00009429,,oa,156,22,8,14,1,9,2,7,122,119,3,2,14.1,5.8,78.2,319355.0375,177649.352
W00009622,,oa,120,54,28,26,3,48,44,4,9,7,2,6,45.0,40.0,7.5,322585.2845,179717.3235
W00008862,,oa,127,67,30,37,0,43,2,41,15,13,2,2,52.8,33.9,11.8,315700.3425,176862.739
W00008866,,oa,138,88,30,58,2,19,2,17,27,24,3,2,63.8,13.8,19.6,316040.7,176798.728
W00008867,,oa,124,80,33,47,1,4,2,2,39,36,3,0,64.5,3.2,31.5,315774.0685,176737.3715
W00008860,,oa,139,92,36,56,0,3,1,2,42,38,4,2,66.2,2.2,30.2,316286.73199999996,176837.94199999998
W00008869,,oa,149,87,41,46,1,7,1,6,50,49,1,4,58.4,4.7,33.6,316234.918,176680.2645
W00009342,,oa,155,57,23,34,2,83,81,2,10,9,1,3,36.8,53.5,6.5,320811.3355,181057.514
W00009533,,oa,136,128,99,29,0,2,1,1,6,5,1,0,94.1,1.5,4.4,315825.00800000003,181920.96149999998
W00009636,,oa,120,69,22,47,0,26,4,22,23,22,1,2,57.5,21.7,19.2,320426.47250000003,176415.8695
W00009633,,oa,163,59,18,41,0,64,3,61,30,27,3,10,36.2,39.3,18.4,319823.07,176439.507
W00009164,,oa,115,104,54,50,0,1,1,0,9,9,0,1,90.4,0.9,7.8,317397.13300000003,180542.7015
W00009162,,oa,115,106,56,50,0,4,2,2,3,3,0,2,92.2,3.5,2.6,317158.93200000003,180401.66999999998
W00008923,,oa,141,56,25,31,1,2,0,2,80,77,3,2,39.7,1.4,56.7,318402.2025,178116.1975
W00008920,,oa,128,40,19,21,0,1,1,0,86,77,9,1,31.3,0.8,67.2,318358.5255,178451.44150000002
W00008872,,oa,122,96,30,66,0,7,3,4,17,16,1,2,78.7,5.7,13.9,315850.55850000004,176500.4605
W00008873,,oa,140,103,49,54,0,5,1,4,31,30,1,1,73.6,3.6,22.1,316089.4375,176552.0565
W00008871,,oa,161,95,40,55,0,5,1,4,60,59,1,1,59.0,3.1,37.3,316400.5125,176609.0655
W00008879,,oa,135,103,45,58,0,3,1,2,27,22,5,2,76.3,2.2,20.0,316429.90650000004,176321.6995
W00009080,,oa,158,57,30,27,2,2,1,1,94,83,11,3,36.1,1.3,59.5,317767.475,178583.4045
W00009088,,oa,147,50,15,35,1,4,1,3,89,87,2,3,34.0,2.7,60.5,317485.1455,178602.501
W00009586,,oa,143,50,23,27,0,40,0,40,52,52,0,1,35.0,28.0,36.4,316568.8515,176972.49349999998
W00009585,,oa,115,77,34,43,0,8,3,5,27,25,2,3,67.0,7.0,23.5,316852.163,176979.1115
W00009581,,oa,145,84,37,47,0,6,3,3,55,54,1,0,57.9,4.1,37.9,316446.642,177266.3395
W00009580,,oa,190,42,15,27,1,3,1,2,144,142,2,0,22.1,1.6,75.8,317086.372,177393.84649999999
W00009458,,oa,116,59,28,31,1,1,1,0,53,51,2,2,50.9,0.9,45.7,318820.66500000004,178222.5185
W00009765,,oa,110,98,48,50,0,0,0,0,10,10,0,2,89.1,0.0,9.1,315793.57550000004,179890.47749999998
W00009764,,oa,124,114,78,36,0,3,1,2,7,7,0,0,91.9,2.4,5.6,316303.421,179918.5745
W00009094,,oa,129,87,30,57,0,16,4,12,23,22,1,3,67.4,12.4,17.8,316986.519,175189.1175
W00010223,,oa,82,20,6,14,0,14,0,14,47,45,2,1,24.4,17.1,57.3,317449.047,177961.2035
W00009277,,oa,128,118,66,52,2,1,0,1,5,5,0,2,92.2,0.8,3.9,316568.54949999996,182710.304
W00009597,,oa,192,60,19,41,0,15,1,14,115,112,3,2,31.3,7.8,59.9,316863.47,176574.76799999998
W00009594,,oa,149,98,30,68,1,3,0,3,45,43,2,2,65.8,2.0,30.2,316697.6065,176788.7305
W00009591,,oa,139,95,46,49,0,0,0,0,42,40,2,2,68.3,0.0,30.2,316870.93200000003,176741.6995
W00009598,,oa,122,64,38,26,0,27,17,10,27,23,4,4,52.5,22.1,22.1,316897.5,176393.4155
W00009324,,oa,131,80,19,61,0,33,31,2,15,11,4,3,61.1,25.2,11.5,321677.13,181190.2465
W00008603,,oa,161,133,55,78,0,0,0,0,26,25,1,2,82.6,0.0,16.1,325221.40599999996,183023.34350000002
W00009687,,oa,106,88,33,55,0,3,2,1,15,13,2,0,83.0,2.8,14.2,323610.58200000005,181405.46149999998
W00009325,,oa,124,60,23,37,0,50,43,7,13,12,1,1,48.4,40.3,10.5,322378.88,181399.2605
W00010151,,oa,133,87,11,76,1,24,0,24,21,19,2,0,65.4,18.0,15.8,316946.9745,181329.921
W00009360,,oa,118,91,38,53,2,14,14,0,10,10,0,1,77.1,11.9,8.5,319861.67949999997,179991.6925
W00009720,,oa,127,82,36,46,0,36,26,10,8,7,1,1,64.6,28.3,6.3,313500.099,182235.6595
W00009234,,oa,108,70,35,35,0,16,13,3,22,19,3,0,64.8,14.8,20.4,315070.2685,179092.89
W00010152,,oa,129,79,8,71,0,4,1,3,45,44,1,1,61.2,3.1,34.9,313766.042,179989.17599999998
W00009247,,oa,147,112,43,69,1,1,0,1,32,28,4,1,76.2,0.7,21.8,317373.105,182667.766
W00010135,,oa,130,80,16,64,0,1,1,0,45,44,1,4,61.5,0.8,34.6,316843.126,180590.7365
W00009140,,oa,146,125,67,58,0,3,3,0,18,16,2,0,85.6,2.1,12.3,316965.17350000003,180033.23200000002
W00009141,,oa,181,123,50,73,0,6,1,5,50,46,4,2,68.0,3.3,27.6,316721.6925,180194.2625
W00009148,,oa,78,32,21,11,14,22,0,22,9,9,0,1,41.0,28.2,11.5,318158.9975,179859.50400000002
W00009245,,oa,183,155,60,95,2,0,0,0,26,22,4,0,84.7,0.0,14.2,316623.083,183146.314
W00009249,,oa,140,117,68,49,0,0,0,0,19,16,3,4,83.6,0.0,13.6,318284.22,182297.78350000002
W00009745,,oa,115,97,54,43,0,2,1,1,15,14,1,1,84.3,1.7,13.0,314689.3875,180910.05949999997
W00009747,,oa,123,56,33,23,0,54,2,52,10,7,3,3,45.5,43.9,8.1,315001.72349999996,180675.491
W00009749,,oa,134,130,60,70,1,1,0,1,2,2,0,0,97.0,0.7,1.5,315232.406,180554.89549999998
W00009156,,oa,111,106,56,50,0,1,0,1,3,3,0,1,95.5,0.9,2.7,317522.7725,180776.34850000002
W00009153,,oa,121,101,46,55,0,0,0,0,19,14,5,1,83.5,0.0,15.7,316949.954,179484.2035
W00009252,,oa,178,142,85,57,1,4,2,2,26,24,2,5,79.8,2.2,14.6,317917.50450000004,181871.7645
W00009258,,oa,138,94,46,48,0,32,30,2,12,12,0,0,68.1,23.2,8.7,317895.365,181367.98700000002
W00009259,,oa,121,56,27,29,1,53,52,1,7,5,2,4,46.3,43.8,5.8,318022.177,181201.4005
W00009486,,oa,142,121,23,98,0,0,0,0,18,15,3,3,85.2,0.0,12.7,320170.9175,182088.239
W00009758,,oa,119,111,55,56,0,0,0,0,8,8,0,0,93.3,0.0,6.7,314988.74950000003,180158.7175
W00009364,,oa,133,115,46,69,0,9,1,8,9,8,1,0,86.5,6.8,6.8,319835.9805,179659.4525
W00009229,,oa,141,124,46,78,0,2,2,0,13,13,0,2,87.9,1.4,9.2,314727.8715,179335
W00006525,,oa,126,109,49,60,0,4,2,2,13,12,1,0,86.5,3.2,10.3,312525.5455,184063.022
W00009412,,oa,128,109,55,54,2,1,0,1,16,15,1,0,85.2,0.8,12.5,320035.1225,179246.26049999997
W00009726,,oa,128,109,65,44,0,0,0,0,16,13,3,3,85.2,0.0,12.5,315241.59699999995,179814.728
W00009727,,oa,112,108,58,50,0,1,0,1,2,2,0,1,96.4,0.9,1.8,316183.1165,179521.9135
W00009728,,oa,124,97,52,45,0,8,7,1,16,15,1,3,78.2,6.5,12.9,315654.00749999995,179541.638
W00009729,,oa,126,116,80,36,0,0,0,0,7,4,3,3,92.1,0.0,5.6,316386.773,179389.146
W00008967,,oa,97,41,13,28,0,45,1,44,11,10,1,0,42.3,46.4,11.3,318895.922,180163.869
W00008964,,oa,136,97,60,37,1,0,0,0,38,33,5,0,71.3,0.0,27.9,318878.2105,180280.07549999998
W00008963,,oa,135,115,78,37,1,5,0,5,13,12,1,1,85.2,3.7,9.6,319243.179,180381.557
W00009230,,oa,141,85,34,51,0,47,42,5,9,6,3,0,60.3,33.3,6.4,315167.5885,179216
W00009540,,oa,117,108,66,42,1,2,1,1,6,5,1,0,92.3,1.7,5.1,316398.1855,181366.15000000002
W00009549,,oa,126,112,45,67,0,1,1,0,10,8,2,3,88.9,0.8,7.9,316501.7635,180832.407
W00009736,,oa,137,118,54,64,1,1,0,1,16,16,0,1,86.1,0.7,11.7,316532.788,179317.48599999998
W00009731,,oa,123,94,30,64,0,1,0,1,27,27,0,1,76.4,0.8,22.0,316469.577,179574.8695
W00009735,,oa,120,97,55,42,0,2,0,2,21,20,1,0,80.8,1.7,17.5,316705.81200000003,179403.213
W00008971,,oa,124,116,61,55,0,0,0,0,7,6,1,1,93.5,0.0,5.6,318265.7035,180053.50400000002
W00009184,,oa,126,119,80,39,0,0,0,0,7,6,1,0,94.4,0.0,5.6,318696.678,183279.8095
W00009182,,oa,127,125,71,54,0,0,0,0,0,0,0,2,98.4,0.0,0.0,318349.901,183266.91499999998
W00009189,,oa,129,102,48,54,1,1,0,1,23,23,0,2,79.1,0.8,17.8,314041.622,179371.276
W00009188,,oa,128,106,27,79,0,2,1,1,20,19,1,0,82.8,1.6,15.6,313895.911,179460.4895
W00009282,,oa,115,79,34,45,2,7,6,1,27,27,0,0,68.7,6.1,23.5,316873.229,182453.1015
W00009281,,oa,129,91,30,61,0,22,19,3,11,8,3,5,70.5,17.1,8.5,317384.97,182363.089
W00009556,,oa,125,124,79,45,0,0,0,0,1,1,0,0,99.2,0.0,0.8,315270.46900000004,182082.6615
W00009553,,oa,135,125,79,46,0,0,0,0,10,10,0,0,92.6,0.0,7.4,315817.1505,182166.478
W00009376,,oa,189,125,47,78,0,54,13,41,6,6,0,4,66.1,28.6,3.2,311961.08999999997,182732.5385
W00009526,,oa,146,139,83,56,0,0,0,0,7,7,0,0,95.2,0.0,4.8,315239.184,181495.3195
W00009522,,oa,129,121,95,26,0,0,0,0,8,7,1,0,93.8,0.0,6.2,316120.917,182032.7445
W00006515,,oa,218,154,39,115,3,30,13,17,27,23,4,4,70.6,13.8,12.4,312257.7275,183568.5045
W00009528,,oa,129,119,83,36,0,0,0,0,10,7,3,0,92.2,0.0,7.8,316078.2705,181867.401
W00009716,,oa,131,108,52,56,0,2,2,0,16,16,0,5,82.4,1.5,12.2,313824.07849999995,183346.7825
W00008954,,oa,150,121,66,55,0,0,0,0,27,27,0,2,80.7,0.0,18.0,318493.00399999996,180852.3335
W00008957,,oa,134,115,66,49,0,0,0,0,14,13,1,5,85.8,0.0,10.4,318313.93350000004,180851.9995
W00008952,,oa,125,120,81,39,0,1,1,0,2,2,0,2,96.0,0.8,1.6,319609.85750000004,181449.7855
W00008951,,oa,148,126,55,71,1,0,0,0,19,18,1,2,85.1,0.0,12.8,318278.428,181218.32400000002
W00009348,,oa,131,118,50,68,0,6,5,1,5,4,1,2,90.1,4.6,3.8,319642.802,180413.305
W00009534,,oa,131,113,67,46,1,0,0,0,15,13,2,2,86.3,0.0,11.5,316480.797,181665.759
W00009539,,oa,121,117,63,54,0,1,1,0,3,3,0,0,96.7,0.8,2.5,316417.9865,181462.64299999998
W00010150,,oa,126,117,45,72,0,0,0,0,7,7,0,2,92.9,0.0,5.6,312344.078,180167.0725
W00009166,,oa,128,112,63,49,1,4,0,4,9,8,1,2,87.5,3.1,7.0,316301.5285,180311.843
W00009169,,oa,145,129,72,57,0,2,1,1,14,10,4,0,89.0,1.4,9.7,317956.0435,180339.00300000003
W00009351,,oa,110,77,28,49,0,23,19,4,9,9,0,1,70.0,20.9,8.2,320481.368,180286.30550000002
W00009266,,oa,121,91,39,52,1,3,1,2,26,24,2,0,75.2,2.5,21.5,317582.579,183108.8995
W00009267,,oa,119,77,30,47,1,2,0,2,39,38,1,0,64.7,1.7,32.8,317238.717,183182.013
W00009264,,oa,121,105,44,61,1,0,0,0,13,13,0,2,86.8,0.0,10.7,317770.799,183197.225
W00009262,,oa,114,101,39,62,0,2,1,1,11,10,1,0,88.6,1.8,9.6,317551.4865,183487.72999999998
W00009268,,oa,122,85,30,55,5,1,0,1,29,27,2,2,69.7,0.8,23.8,317696.4445,183088.046
W00009269,,oa,117,77,25,52,4,1,0,1,35,32,3,0,65.8,0.9,29.9,317177.293,183018.087
W00009503,,oa,208,185,102,83,0,10,0,10,12,8,4,1,88.9,4.8,5.8,312794.70900000003,180568.415
W00009766,,oa,129,120,71,49,0,2,0,2,7,7,0,0,93.0,1.6,5.4,315957.908,179908.995
W00009763,,oa,133,113,39,74,1,2,0,2,17,16,1,0,85.0,1.5,12.8,314257.8345,179922.7555
W00009760,,oa,139,87,41,46,1,29,27,2,21,18,3,1,62.6,20.9,15.1,314495.838,180086.84350000002
W00009172,,oa,135,125,70,55,0,0,0,0,9,9,0,1,92.6,0.0,6.7,316164.68000000005,180146.90350000001
W00009178,,oa,118,95,66,29,0,1,0,1,15,14,1,7,80.5,0.8,12.7,318566.7825,182842.8225
W00009517,,oa,144,133,78,55,0,0,0,0,9,9,0,2,92.4,0.0,6.3,316140.69550000003,181558.0235
W00010228,,oa,123,114,27,87,0,2,2,0,7,6,1,0,92.7,1.6,5.7,310753.997,180208.74
W00010227,,oa,104,74,25,49,0,19,6,13,11,9,2,0,71.2,18.3,10.6,312502.319,181738.0565
W00009279,,oa,113,94,39,55,0,9,7,2,8,8,0,2,83.2,8.0,7.1,317119.473,182492.2905
W00009514,,oa,125,119,67,52,0,0,0,0,4,4,0,2,95.2,0.0,3.2,312713.3645,181700.4445
W00009515,,oa,124,100,53,47,0,11,11,0,12,10,2,1,80.6,8.9,9.7,312777.392,181670.682
W00009615,,oa,111,92,52,40,0,9,7,2,9,8,1,1,82.9,8.1,8.1,322359.8395,180217.0915
W00009699,,oa,100,32,7,25,0,53,17,36,12,9,3,3,32.0,53.0,12.0,323016.897,180951.8095
W00009713,,oa,153,78,36,42,0,55,37,18,18,18,0,2,51.0,35.9,11.8,323425.7575,180082.67
W00009306,,oa,103,55,21,34,2,39,37,2,3,3,0,4,53.4,37.9,2.9,322285.891,180507.972
W00009300,,oa,118,73,31,42,0,33,31,2,8,6,2,4,61.9,28.0,6.8,322194.135,180882.8885
W00009483,,oa,84,68,25,43,0,2,0,2,13,13,0,1,81.0,2.4,15.5,322838.848,181177.8985
W00009673,,oa,141,50,25,25,2,80,58,22,8,6,2,1,35.5,56.7,5.7,323078.33349999995,180294.71899999998
W00009670,,oa,157,94,41,53,0,50,20,30,11,8,3,2,59.9,31.8,7.0,323039.4045,180477.3785
W00010179,,oa,76,16,6,10,2,49,26,23,8,8,0,1,21.1,64.5,10.5,323512.703,180450.8615
W00009709,,oa,237,166,24,142,2,7,3,4,62,57,5,0,70.0,3.0,26.2,324223.70200000005,180497.00449999998
W00009295,,oa,157,97,46,51,0,41,26,15,13,10,3,6,61.8,26.1,8.3,322470.81200000003,181173.67700000003
W00009299,,oa,123,64,35,29,0,40,29,11,15,15,0,4,52.0,32.5,12.2,322464.89749999996,180790
W00009298,,oa,126,90,43,47,0,26,23,3,7,7,0,3,71.4,20.6,5.6,322643.856,180898.416
W00009621,,oa,129,44,14,30,0,73,64,9,7,6,1,5,34.1,56.6,5.4,322354.659,179775.63
W00010155,,oa,102,93,18,75,0,1,0,1,8,8,0,0,91.2,1.0,7.8,324001.772,180211.9855
W00009686,,oa,122,100,54,46,1,5,2,3,12,11,1,4,82.0,4.1,9.8,323222.488,181438.463
W00009685,,oa,170,138,47,91,0,3,0,3,28,25,3,1,81.2,1.8,16.5,324245.356,182027.1345
W00009600,,oa,141,90,42,48,0,37,36,1,10,9,1,4,63.8,26.2,7.1,322688.38399999996,180648.829
W00008839,,oa,105,22,12,10,1,76,6,70,6,6,0,0,21.0,72.4,5.7,313164.7665,175759.3515
W00009043,,oa,149,83,25,58,0,55,46,9,7,6,1,4,55.7,36.9,4.7,313226.00800000003,177637.48849999998
W00009040,,oa,128,61,23,38,0,59,53,6,7,4,3,1,47.7,46.1,5.5,313019.817,177957.9725
W00008945,,oa,115,100,24,76,0,3,0,3,11,11,0,1,87.0,2.6,9.6,312321.3915,176428.981
W00008943,,oa,156,141,55,86,1,5,1,4,8,8,0,1,90.4,3.2,5.1,311644.7705,176189.229
W00009026,,oa,110,94,53,41,0,0,0,0,15,12,3,1,85.5,0.0,13.6,311955.2395,175873.6065
W00009024,,oa,132,60,24,36,0,55,49,6,15,12,3,2,45.5,41.7,11.4,312237.1205,175729.184
W00009025,,oa,117,40,14,26,0,66,64,2,9,9,0,2,34.2,56.4,7.7,312687.583,175866.18050000002
W00009022,,oa,127,105,34,71,4,4,3,1,13,9,4,1,82.7,3.1,10.2,311688.73,175707.166
W00009023,,oa,120,51,23,28,0,59,55,4,8,6,2,2,42.5,49.2,6.7,312413.251,175858.1725
W00009021,,oa,139,56,25,31,0,70,63,7,9,8,1,4,40.3,50.4,6.5,312922.5075,175826.849
W00009028,,oa,108,20,10,10,0,75,74,1,5,5,0,8,18.5,69.4,4.6,312426.30799999996,175658.62449999998
W00006517,,oa,132,77,39,38,1,41,32,9,11,8,3,2,58.3,31.1,8.3,313177.5235,183513.3645
W00009033,,oa,124,96,47,49,0,22,15,7,5,3,2,1,77.4,17.7,4.0,312975.6225,177676.4865
W00009006,,oa,134,33,14,19,1,82,78,4,16,15,1,2,24.6,61.2,11.9,312670.353,176291.6575
W00009000,,oa,136,47,21,26,0,81,81,0,7,7,0,1,34.6,59.6,5.1,313720.244,176723.9125
W00009505,,oa,114,94,61,33,0,0,0,0,19,18,1,1,82.5,0.0,16.7,312806.782,180996.674
W00009508,,oa,131,105,52,53,0,1,0,1,24,23,1,1,80.2,0.8,18.3,312227.14,181067.6885
W00008846,,oa,127,37,11,26,0,69,53,16,19,18,1,2,29.1,54.3,15.0,313231.9045,175537.213
W00008845,,oa,124,82,41,41,0,34,32,2,5,5,0,3,66.1,27.4,4.0,313612.65,175504.6085
W00008848,,oa,123,18,5,13,0,96,28,68,9,9,0,0,14.6,78.0,7.3,313664.1985,175294.65850000002
W00008849,,oa,109,33,11,22,0,63,37,26,12,7,5,1,30.3,57.8,11.0,312634.8275,175286.12
W00009014,,oa,135,45,17,28,0,84,84,0,5,4,1,1,33.3,62.2,3.7,313132.5,176185.5685
W00009019,,oa,119,54,14,40,0,53,50,3,10,7,3,2,45.4,44.5,8.4,312411.12899999996,176031.765
W00009012,,oa,120,37,16,21,0,75,72,3,7,6,1,1,30.8,62.5,5.8,313790.43799999997,176392.779
W00010221,,oa,121,71,34,37,0,3,0,3,43,39,4,4,58.7,2.5,35.5,311776.88,177055
W00009510,,oa,129,126,91,35,0,1,1,0,2,2,0,0,97.7,0.8,1.6,312400.086,180711.3625
W00010146,,oa,129,54,6,48,0,32,2,30,42,38,4,1,41.9,24.8,32.6,320976.408,177933.314
W00010180,,oa,131,85,9,76,0,5,2,3,39,32,7,2,64.9,3.8,29.8,321306.0425,178000.0015
W00010175,,oa,119,52,6,46,2,49,46,3,15,10,5,1,43.7,41.2,12.6,321124.9805,181457.12800000003
W00008599,,oa,134,127,36,91,0,0,0,0,4,4,0,3,94.8,0.0,3.0,325381.52650000004,182011.4945
W00010225,,oa,105,71,11,60,16,5,0,5,13,13,0,0,67.6,4.8,12.4,321249.36750000005,181989.58250000002
W00009704,,oa,138,37,16,21,0,93,64,29,6,6,0,2,26.8,67.4,4.3,323229.453,180708.3775
W00009311,,oa,133,96,40,56,0,26,19,7,9,7,2,2,72.2,19.5,6.8,321776.4595,180155.6165
W00009390,,oa,143,122,67,55,0,0,0,0,19,18,1,2,85.3,0.0,13.3,319619.676,178551.74550000002
W00009433,,oa,227,43,25,18,1,37,4,33,145,139,6,1,18.9,16.3,63.9,319661.998,177328.1725
W00009619,,oa,127,60,21,39,1,56,54,2,6,6,0,4,47.2,44.1,4.7,322405.2485,179967.6825
W00009332,,oa,130,77,26,51,0,35,2,33,18,16,2,0,59.2,26.9,13.8,320354.9865,181339.938
W00009665,,oa,114,10,3,7,0,95,13,82,8,7,1,1,8.8,83.3,7.0,321308.9465,176885.682
W00010207,,oa,108,98,13,85,1,3,2,1,5,3,2,1,90.7,2.8,4.6,323722.476,180311.218
W00009985,,oa,139,19,11,8,0,28,3,25,78,77,1,14,13.7,20.1,56.1,319694.9435,177168.311
W00009338,,oa,123,95,22,73,0,9,3,6,19,14,5,0,77.2,7.3,15.4,320192.4305,181074.489
W00009337,,oa,186,134,38,96,1,11,2,9,37,35,2,3,72.0,5.9,19.9,320631.8245,181291.586
W00009334,,oa,132,47,15,32,0,73,60,13,10,8,2,2,35.6,55.3,7.6,321002.46900000004,181259.59600000002
W00009333,,oa,141,123,66,57,1,1,0,1,14,13,1,2,87.2,0.7,9.9,319941.8075,181394.5095
W00009616,,oa,118,65,26,39,0,36,30,6,15,11,4,2,55.1,30.5,12.7,322654.0855,180140.576
W00009617,,oa,107,59,35,24,0,40,6,34,2,1,1,6,55.1,37.4,1.9,322260.7725,180061.20049999998
W00009693,,oa,184,101,38,63,2,62,57,5,14,14,0,5,54.9,33.7,7.6,323516.83400000003,181026.214
W00009612,,oa,124,108,56,52,0,4,0,4,12,8,4,0,87.1,3.2,9.7,321841.534,178825.6635
W00009691,,oa,216,94,11,83,5,75,65,10,41,34,7,1,43.5,34.7,19.0,323854.302,181281.18349999998
W00009690,,oa,132,30,5,25,2,87,78,9,8,8,0,5,22.7,65.9,6.1,324134.96499999997,181288.852
W00009618,,oa,129,70,24,46,1,37,34,3,12,11,1,9,54.3,28.7,9.3,322690.2155,179924.448
W00009372,,oa,117,92,36,56,1,18,5,13,6,6,0,0,78.6,15.4,5.1,320542.97849999997,181604.679
W00009304,,oa,137,126,82,44,0,5,3,2,5,5,0,1,92.0,3.6,3.6,321209.69649999996,180141.32799999998
W00009404,,oa,125,62,23,39,0,26,0,26,34,33,1,3,49.6,20.8,27.2,319914.2375,177738.758
W00009484,,oa,118,18,6,12,0,90,4,86,8,7,1,2,15.3,76.3,6.8,322651.06799999997,181832.0615
W00009403,,oa,127,72,30,42,1,2,0,2,52,48,4,0,56.7,1.6,40.9,319635.7605,177816.5465
W00009481,,oa,147,123,54,69,0,17,14,3,6,5,1,1,83.7,11.6,4.1,323192.451,181704.4455
W00009401,,oa,129,111,52,59,0,2,1,1,16,16,0,0,86.0,1.6,12.4,319627.47849999997,178043.66700000002
W00009489,,oa,130,99,22,77,0,1,0,1,30,30,0,0,76.2,0.8,23.1,320962.453,182458.5745
W00009666,,oa,106,7,4,3,0,96,83,13,2,0,2,1,6.6,90.6,1.9,321157.57550000004,177113.749
W00009663,,oa,116,55,14,41,0,48,43,5,10,10,0,3,47.4,41.4,8.6,320931.098,176881.058
W00009660,,oa,133,89,24,65,2,14,11,3,27,26,1,1,66.9,10.5,20.3,320376.772,177109.28100000002
W00009492,,oa,100,30,4,26,5,39,0,39,24,21,3,2,30.0,39.0,24.0,321170.5875,182368.90899999999
W00009367,,oa,135,92,30,62,0,6,2,4,36,32,4,1,68.1,4.4,26.7,319830.547,179466.29700000002
W00009397,,oa,141,123,62,61,0,2,1,1,16,15,1,0,87.2,1.4,11.3,319850.87600000005,178200.00699999998
W00009394,,oa,136,119,71,48,0,1,0,1,14,12,2,2,87.5,0.7,10.3,319854.72699999996,178449.7885
W00009393,,oa,126,76,36,40,0,36,1,35,12,12,0,2,60.3,28.6,9.5,319595.472,178418.62300000002
W00009310,,oa,141,83,47,36,1,38,37,1,13,11,2,6,58.9,27.0,9.2,322015.35199999996,180061.699
W00009391,,oa,186,125,54,71,0,20,0,20,39,35,4,2,67.2,10.8,21.0,319995.204,178266.714
W00009319,,oa,115,34,11,23,0,70,68,2,7,7,0,4,29.6,60.9,6.1,322522.1185,181685.723
W00009414,,oa,118,113,74,39,0,2,0,2,3,3,0,0,95.8,1.7,2.5,320359.3515,179156.65399999998
W00009415,,oa,139,124,85,39,0,1,0,1,12,11,1,2,89.2,0.7,8.6,319954.1915,179057.28600000002
W00009490,,oa,169,112,35,77,0,47,0,47,9,9,0,1,66.3,27.8,5.3,320295.295,182863.59999999998
W00009411,,oa,174,152,92,60,0,5,1,4,16,16,0,1,87.4,2.9,9.2,319512.0575,179034
W00008779,,oa,151,39,17,22,0,82,45,37,24,20,4,6,25.8,54.3,15.9,319820.2025,177052.8785
W00009676,,oa,99,55,30,25,0,22,11,11,19,15,4,3,55.6,22.2,19.2,323594.597,178802.36800000002
W00009678,,oa,113,96,25,71,0,1,0,1,15,13,2,1,85.0,0.9,13.3,323591.847,181593.21250000002
W00009475,,oa,157,16,6,10,0,15,0,15,125,121,4,1,10.2,9.6,79.6,319420.70200000005,177690.29200000002
W00009478,,oa,129,120,62,58,0,1,0,1,6,6,0,2,93.0,0.8,4.7,323009.50049999997,182739.3
W00009479,,oa,116,89,28,61,0,8,1,7,14,14,0,5,76.7,6.9,12.1,322231.353,182138.4455
W00009711,,oa,134,113,19,94,0,2,1,1,19,15,4,0,84.3,1.5,14.2,324315.4625,180323.658
W00009190,,oa,127,121,62,59,0,0,0,0,6,5,1,0,95.3,0.0,4.7,313920.9485,179183.387
W00009236,,oa,123,55,25,30,0,56,44,12,8,6,2,4,44.7,45.5,6.5,315885.52150000003,178882.391
W00009215,,oa,130,66,25,41,0,40,16,24,24,24,0,0,50.8,30.8,18.5,315467.346,179262.8005
W00009217,,oa,125,43,13,30,0,67,42,25,15,15,0,0,34.4,53.6,12.0,316221.5255,178912.6225
W00009237,,oa,154,72,21,51,0,57,43,14,24,24,0,1,46.8,37.0,15.6,316485.49399999995,178970.90500000003
W00009733,,oa,121,108,64,44,1,3,1,2,5,3,2,4,89.3,2.5,4.1,316023.961,179429.4915
W00009417,,oa,132,126,86,40,0,2,0,2,3,2,1,1,95.5,1.5,2.3,320230.9005,179034.64299999998
W00008972,,oa,117,72,37,35,0,5,4,1,40,40,0,0,61.5,4.3,34.2,319046.4355,179866.96600000001
W00009366,,oa,130,113,49,64,0,6,2,4,11,7,4,0,86.9,4.6,8.5,320006.734,179525.19199999998
W00009555,,oa,118,108,79,29,1,1,0,1,6,6,0,2,91.5,0.8,5.1,316044.47849999997,182297.588
W00009315,,oa,139,109,66,43,1,1,1,0,26,22,4,2,78.4,0.7,18.7,321196.158,179751.6625
W00009312,,oa,136,109,71,38,1,11,9,2,12,11,1,3,80.1,8.1,8.8,321645.34900000005,179919.6335
W00009287,,oa,128,115,78,37,0,2,0,2,11,11,0,0,89.8,1.6,8.6,318697.2135,182085.19799999997
W00009294,,oa,111,55,25,30,0,50,48,2,5,4,1,1,49.5,45.0,4.5,322103.93799999997,180516.2335
W00009675,,oa,136,64,19,45,0,58,50,8,11,10,1,3,47.1,42.6,8.1,322857.42350000003,180171.3785
W00010169,,oa,130,77,23,54,1,36,14,22,15,14,1,1,59.2,27.7,11.5,320867.426,181611.812
W00009487,,oa,126,107,40,67,1,1,0,1,17,12,5,0,84.9,0.8,13.5,320766.9515,182039.46850000002
W00009086,,oa,135,77,28,49,1,4,2,2,51,48,3,2,57.0,3.0,37.8,317299.47349999996,178847.957
W00009353,,oa,130,90,34,56,0,16,15,1,23,20,3,1,69.2,12.3,17.7,319858.26300000004,180310.3805
W00009604,,oa,105,75,25,50,0,16,12,4,13,12,1,1,71.4,15.2,12.4,321935.198,179120.2145
W00009150,,oa,140,128,70,58,0,0,0,0,10,10,0,2,91.4,0.0,7.1,317012.6135,179766.878
W00009757,,oa,119,75,33,42,0,34,34,0,9,8,1,1,63.0,28.6,7.6,314791.15449999995,180209.064
W00009313,,oa,124,82,54,28,0,3,2,1,37,31,6,2,66.1,2.4,29.8,321468.9895,179732.98700000002
W00009227,,oa,134,97,43,54,0,7,4,3,27,25,2,3,72.4,5.2,20.1,314946.8025,179346.655
W00009225,,oa,147,110,39,71,0,11,3,8,26,24,2,0,74.8,7.5,17.7,314407.75,179639.6555
W00009220,,oa,129,72,30,42,1,38,35,3,14,9,5,4,55.8,29.5,10.9,315581.566,178890.7955
W00009410,,oa,124,117,60,57,1,2,0,2,3,2,1,1,94.4,1.6,2.4,319096.05,179179.3985
W00009734,,oa,124,79,43,36,0,35,6,29,7,7,0,3,63.7,28.2,5.6,315507.858,179417.038
W00008975,,oa,115,96,47,49,1,1,0,1,17,17,0,0,83.5,0.9,14.8,318341.9895,179620.9595
W00009620,,oa,123,66,33,33,0,47,40,7,9,3,6,1,53.7,38.2,7.3,322102.78150000004,179805.54200000002
W00009084,,oa,141,74,38,36,0,3,0,3,62,55,7,2,52.5,2.1,44.0,317078.571,178948.29200000002
W00009085,,oa,155,55,28,27,2,7,5,2,84,79,5,7,35.5,4.5,54.2,317397.663,178948.418
W00009602,,oa,115,102,53,49,0,4,2,2,9,8,1,0,88.7,3.5,7.8,321528.72,179312.925
W00009603,,oa,119,69,23,46,0,40,27,13,10,7,3,0,58.0,33.6,8.4,322123.18799999997,179269.71850000002
W00009601,,oa,127,92,46,46,0,21,19,2,13,12,1,1,72.4,16.5,10.2,321874.9815,179385.83
W00009512,,oa,175,149,79,70,3,5,5,0,13,13,0,5,85.1,2.9,7.4,313333.9355,180287.519
W00009748,,oa,113,67,38,29,0,35,2,33,11,10,1,0,59.3,31.0,9.7,314886.065,180581.827
W00009152,,oa,133,110,57,53,1,1,0,1,21,18,3,0,82.7,0.8,15.8,317066.6755,179389.47999999998
W00009746,,oa,135,124,65,59,3,3,0,3,4,4,0,1,91.9,2.2,3.0,315096.591,180775.44150000002
W00009525,,oa,126,118,76,42,0,0,0,0,4,4,0,4,93.7,0.0,3.2,314949.35699999996,181992.934
W00009261,,oa,152,129,55,74,2,10,7,3,9,8,1,2,84.9,6.6,5.9,317929.598,180811.8605
W00009254,,oa,172,113,80,33,0,15,1,14,41,40,1,3,65.7,8.7,23.8,317645.2175,181713.38400000002
W00009416,,oa,129,116,69,47,0,3,0,3,8,7,1,2,89.9,2.3,6.2,318938.45149999997,178910.388
W00008949,,oa,129,120,72,48,0,0,0,0,7,7,0,2,93.0,0.0,5.4,319187.792,181416.3365
W00009232,,oa,141,94,41,53,0,34,27,7,12,10,2,1,66.7,24.1,8.5,316163.3375,179099.412
W00009542,,oa,99,96,56,40,0,0,0,0,2,2,0,1,97.0,0.0,2.0,315658.5245,181151.58899999998
W00009532,,oa,159,138,97,41,0,0,0,0,20,17,3,1,86.8,0.0,12.6,315818.976,181703.6555
W00009530,,oa,122,94,43,51,0,1,1,0,27,26,1,0,77.0,0.8,22.1,314841.79850000003,181707.37050000002
W00009163,,oa,123,113,45,68,0,0,0,0,10,7,3,0,91.9,0.0,8.1,317585.7895,180511.27649999998
W00009507,,oa,129,122,79,43,0,1,0,1,4,4,0,2,94.6,0.8,3.1,312544.78500000003,180926.303
W00009509,,oa,126,122,77,45,0,0,0,0,4,4,0,0,96.8,0.0,3.2,311920.32550000004,181013.9095
W00009767,,oa,125,116,66,50,0,1,1,0,5,5,0,3,92.8,0.8,4.0,314690.941,179790.1615
W00010128,,oa,69,64,34,30,0,1,1,0,4,3,1,0,92.8,1.4,5.8,319260.9915,179066.6665
W00009171,,oa,211,169,66,103,0,4,4,0,38,36,2,0,80.1,1.9,18.0,316501.704,180417.01650000003
W00009516,,oa,166,152,37,115,0,0,0,0,14,10,4,0,91.6,0.0,8.4,312023.4105,181460.03850000002
W00009644,,oa,128,51,22,29,0,42,1,41,32,29,3,3,39.8,32.8,25.0,319614.5795,176384.414
W00009599,,oa,139,45,25,20,0,11,1,10,81,79,2,2,32.4,7.9,58.3,317561.9675,176487.4805
W00010201,,oa,116,49,12,37,0,2,1,1,64,62,2,1,42.2,1.7,55.2,318747.40650000004,174831.487
W00005834,,oa,122,53,25,28,0,53,1,52,15,15,0,1,43.4,43.4,12.3,316930.217,173226.2265
W00009560,,oa,164,47,25,22,3,16,4,12,93,92,1,5,28.7,9.8,56.7,317368.4805,176351.94150000002
W00009577,,oa,137,71,38,33,0,1,0,1,61,61,0,4,51.8,0.7,44.5,316824.60750000004,177366.2095
W00010204,,oa,133,48,14,34,0,6,3,3,77,73,4,2,36.1,4.5,57.9,318674.313,174838.92200000002
W00009292,,oa,118,105,72,33,5,2,1,1,5,4,1,1,89.0,1.7,4.2,318053.4255,182042.44199999998
W00009291,,oa,133,43,22,21,0,82,74,8,3,3,0,5,32.3,61.7,2.3,317469.57149999996,182017.7145
W00009256,,oa,142,107,49,58,1,4,1,3,30,29,1,0,75.4,2.8,21.1,318213.9915,181472.7125
W00009075,,oa,123,70,22,48,1,3,2,1,49,42,7,0,56.9,2.4,39.8,317422.759,178650.1655
W00010190,,oa,106,49,11,38,0,21,0,21,35,33,2,1,46.2,19.8,33.0,316993.3625,180626.75449999998
W00009125,,oa,144,81,31,50,0,16,5,11,46,41,5,1,56.3,11.1,31.9,317352.2955,175643.93050000002
W00009246,,oa,147,87,29,58,10,39,1,38,8,7,1,3,59.2,26.5,5.4,317330.0675,182998.8175
W00009146,,oa,141,131,79,52,0,2,2,0,8,7,1,0,92.9,1.4,5.7,317757.3015,179848.4075
W00009149,,oa,143,136,67,69,0,1,1,0,5,4,1,1,95.1,0.7,3.5,317077.177,179856.188
W00008980,,oa,128,117,77,40,0,1,0,1,10,9,1,0,91.4,0.8,7.8,319177.9925,181952.4075
W00009241,,oa,169,45,18,27,0,112,100,12,12,9,3,0,26.6,66.3,7.1,317491.978,181022.50699999998
W00009242,,oa,139,90,35,55,3,10,0,10,34,34,0,2,64.7,7.2,24.5,317013.251,183488.522
W00009437,,oa,208,8,6,2,0,25,2,23,172,167,5,3,3.8,12.0,82.7,318787.445,177251.71000000002
W00009431,,oa,109,55,30,25,0,6,1,5,48,42,6,0,50.5,5.5,44.0,319127.426,177548.99550000002
W00009111,,oa,125,96,38,58,0,6,2,4,23,23,0,0,76.8,4.8,18.4,318146.36100000003,174804.4225
W00010145,,oa,111,25,5,20,9,2,1,1,75,71,4,0,22.5,1.8,67.6,318086.105,173046.0235
W00008781,,oa,239,63,25,38,0,29,7,22,143,140,3,4,26.4,12.1,59.8,319565.704,176942.5165
W00009697,,oa,132,17,3,14,1,106,5,101,6,6,0,2,12.9,80.3,4.5,323833.8075,181008.1055
W00009700,,oa,142,38,14,24,9,82,5,77,11,9,2,2,26.8,57.7,7.7,323859.5175,180822.33000000002
W00010174,,oa,91,79,22,57,0,2,0,2,10,9,1,0,86.8,2.2,11.0,321665.2,182140.5945
W00009296,,oa,122,76,35,41,0,35,35,0,6,4,2,5,62.3,28.7,4.9,322164.6615,181049.67349999998
W00009297,,oa,130,79,39,40,0,39,34,5,9,6,3,3,60.8,30.0,6.9,321888.5,180954.887
W00009293,,oa,142,78,16,62,1,47,44,3,16,15,1,0,54.9,33.1,11.3,321671.912,181024.6805
W00009326,,oa,120,43,13,30,0,63,58,5,12,10,2,2,35.8,52.5,10.0,322221.613,181275.8805
W00009329,,oa,138,85,33,52,0,38,33,5,11,8,3,4,61.6,27.5,8.0,322408.9445,181038.3135
W00008602,,oa,125,117,68,49,1,0,0,0,6,5,1,1,93.6,0.0,4.8,325869.9575,183019.33049999998
W00010136,,oa,114,53,17,36,1,50,0,50,8,7,1,2,46.5,43.9,7.0,320789.32649999997,182184.006
W00009482,,oa,141,95,52,43,0,22,21,1,21,19,2,3,67.4,15.6,14.9,323043.49549999996,181848.52850000001
W00009480,,oa,97,66,19,47,0,16,2,14,14,13,1,1,68.0,16.5,14.4,322759.824,181766.20500000002
W00009488,,oa,140,134,51,83,0,0,0,0,6,6,0,0,95.7,0.0,4.3,320750.19700000004,182454.8115
W00009497,,oa,161,129,44,85,0,2,1,1,30,27,3,0,80.1,1.2,18.6,320570.615,182091.183
W00009493,,oa,129,83,16,67,0,0,0,0,43,41,2,3,64.3,0.0,33.3,321604.89650000003,182334.516
W00009502,,oa,140,112,21,91,0,1,0,1,27,26,1,0,80.0,0.7,19.3,321415.4495,182493.7165
W00009680,,oa,122,34,3,31,0,79,77,2,6,5,1,3,27.9,64.8,4.9,324000.5045,181401.913
W00009684,,oa,146,117,48,69,1,1,0,1,26,25,1,1,80.1,0.7,17.8,323919.8155,181678.6315
W00009689,,oa,119,69,17,52,0,17,1,16,33,30,3,0,58.0,14.3,27.7,324177.391,181514.5375
W00009327,,oa,134,45,21,24,0,70,66,4,11,11,0,8,33.6,52.2,8.2,321965.71849999996,181259.9645
W00009322,,oa,134,61,21,40,0,60,53,7,9,9,0,4,45.5,44.8,6.7,322089.2655,181451.2095
W00009323,,oa,123,49,14,35,0,59,56,3,13,13,0,2,39.8,48.0,10.6,321696.9535,181393.00699999998
W00009339,,oa,119,32,10,22,1,70,63,7,14,12,2,2,26.9,58.8,11.8,320560,181077
W00009143,,oa,118,107,59,48,0,1,0,1,9,9,0,1,90.7,0.8,7.6,317235.5,179862.5
W00009744,,oa,167,34,14,20,2,125,123,2,4,4,0,2,20.4,74.9,2.4,314307.5325,180875.7625
W00009501,,oa,144,111,37,74,2,2,0,2,28,27,1,1,77.1,1.4,19.4,321241.35250000004,183544.7765
W00010189,,oa,83,62,6,56,0,1,0,1,20,20,0,0,74.7,1.2,24.1,321483.347,181979.1825
W00010218,,oa,80,61,18,43,0,5,2,3,14,14,0,0,76.3,6.3,17.5,316801.3145,180448.8025
W00009317,,oa,125,55,20,35,0,60,59,1,5,3,2,5,44.0,48.0,4.0,322235.659,181770.375
W00009683,,oa,143,127,43,84,1,3,1,2,11,11,0,1,88.8,2.1,7.7,323778.2785,181833.6355
W00010156,,oa,112,56,10,46,0,0,0,0,55,53,2,1,50.0,0.0,49.1,321003.18200000003,182056.289
W00009142,,oa,121,69,36,33,0,23,22,1,27,26,1,2,57.0,19.0,22.3,316589.13950000005,180092.4005
W00009743,,oa,129,112,46,66,1,5,4,1,10,9,1,1,86.8,3.9,7.8,314951.593,181098.06199999998
W00009157,,oa,210,135,60,75,0,26,5,21,49,44,5,0,64.3,12.4,23.3,317083.5925,180740.23849999998
W00009302,,oa,139,90,39,51,1,41,40,1,7,6,1,0,64.7,29.5,5.0,321270.5455,180555.63549999997
W00009303,,oa,126,46,19,27,0,73,68,5,5,4,1,2,36.5,57.9,4.0,321789.7875,180450.646
W00009308,,oa,110,59,27,32,0,45,43,2,4,4,0,2,53.6,40.9,3.6,322119.554,180359.19
W00009255,,oa,135,80,39,41,0,43,40,3,10,7,3,2,59.3,31.9,7.4,316887.321,181903.1235
W00009250,,oa,139,93,39,54,1,33,31,2,12,10,2,0,66.9,23.7,8.6,317281.949,181811.12699999998
W00009251,,oa,126,117,81,36,0,1,1,0,5,3,2,3,92.9,0.8,4.0,318479.0695,181692.2005
W00009496,,oa,138,111,17,94,0,1,0,1,26,23,3,0,80.4,0.7,18.8,321421.294,182142.0415
W00009495,,oa,128,88,16,72,1,3,0,3,35,33,2,1,68.8,2.3,27.3,320989.38049999997,182347.4925
W00009494,,oa,178,125,27,98,6,21,1,20,25,25,0,1,70.2,11.8,14.0,320349.6865,182239.291
W00009491,,oa,195,150,29,121,1,3,0,3,41,38,3,0,76.9,1.5,21.0,320968,182547.9835
W00009547,,oa,113,109,69,40,0,0,0,0,3,2,1,1,96.5,0.0,2.7,316259.3835,181029.633
W00009180,,oa,121,116,73,43,0,1,0,1,4,4,0,0,95.9,0.8,3.3,318742.4985,182451.4535
W00009368,,oa,120,103,41,62,1,7,0,7,9,8,1,0,85.8,5.8,7.5,319873.051,181856.955
W00009283,,oa,121,114,54,60,1,2,0,2,4,4,0,0,94.2,1.7,3.3,316669.4705,182347.6995
W00009551,,oa,123,106,70,36,1,5,4,1,10,8,2,1,86.2,4.1,8.1,315829.83499999996,180712.3645
W00009702,,oa,143,70,22,48,0,52,43,9,19,17,2,2,49.0,36.4,13.3,323362.5,180545.509
W00009524,,oa,131,111,73,38,1,1,0,1,17,16,1,1,84.7,0.8,13.0,316494.4005,181790.793
W00009710,,oa,133,96,44,52,1,27,20,7,8,5,3,1,72.2,20.3,6.0,323165.745,180512.481
W00008953,,oa,122,112,62,50,0,0,0,0,10,9,1,0,91.8,0.0,8.2,318966.49450000003,181043.2775
W00009538,,oa,127,84,48,36,1,4,4,0,37,35,2,1,66.1,3.1,29.1,315198.0115,181027.164
W00009354,,oa,150,60,22,38,0,77,73,4,12,10,2,1,40.0,51.3,8.0,320269.4395,180134.734
W00009359,,oa,132,48,12,36,6,69,68,1,8,7,1,1,36.4,52.3,6.1,319950.593,180239.715
W00009175,,oa,131,124,55,69,0,0,0,0,5,5,0,2,94.7,0.0,3.8,317556.15249999997,184253.077
W00009274,,oa,127,125,55,70,0,0,0,0,2,2,0,0,98.4,0.0,1.6,317133.65249999997,182711.9345
W00009270,,oa,109,105,48,57,0,0,0,0,3,3,0,1,96.3,0.0,2.8,316778.206,182991.948
W00009518,,oa,119,103,51,52,0,2,1,1,14,13,1,0,86.6,1.7,11.8,316338.6425,180850.8615
W00008819,,oa,113,54,23,31,0,43,41,2,11,10,1,5,47.8,38.1,9.7,313448.515,175078.3515
W00008838,,oa,123,48,15,33,0,54,33,21,19,18,1,2,39.0,43.9,15.4,313618.641,175688.674
W00008833,,oa,185,82,22,60,0,83,33,50,17,13,4,3,44.3,44.9,9.2,313872.6415,176145.612
W00009056,,oa,130,120,63,57,0,0,0,0,10,7,3,0,92.3,0.0,7.7,313704.5455,177097.237
W00009051,,oa,140,129,71,58,0,3,3,0,7,5,2,1,92.1,2.1,5.0,313779.10750000004,177313.265
W00009035,,oa,133,120,44,76,0,3,1,2,7,6,1,3,90.2,2.3,5.3,313561.6435,177409.1225
W00008861,,oa,139,117,68,49,1,7,4,3,14,14,0,0,84.2,5.0,10.1,316125.66949999996,176118.1125
W00009045,,oa,140,92,40,52,0,33,30,3,12,9,3,3,65.7,23.6,8.6,313746.92000000004,177597.965
W00009032,,oa,149,18,3,15,3,111,111,0,11,11,0,6,12.1,74.5,7.4,313269.5,177946.02250000002
W00009031,,oa,137,88,40,48,1,26,21,5,19,14,5,3,64.2,19.0,13.9,313817.299,178049
W00009030,,oa,141,106,43,63,0,8,8,0,25,23,2,2,75.2,5.7,17.7,314137.01450000005,178315.241
W00009446,,oa,165,7,3,4,1,10,1,9,147,146,1,0,4.2,6.1,89.1,318833.68850000005,177087.61800000002
W00009721,,oa,128,80,34,46,0,41,40,1,6,5,1,1,62.5,32.0,4.7,314100.007,181944.215
W00009009,,oa,142,64,24,40,1,63,62,1,13,12,1,1,45.1,44.4,9.2,313684.9745,176302.15350000001
W00008847,,oa,128,48,22,26,1,69,28,41,9,6,3,1,37.5,53.9,7.0,313781.248,175392.7715
W00008831,,oa,159,86,28,58,0,58,6,52,14,9,5,1,54.1,36.5,8.8,314327.914,176310.7135
W00008830,,oa,145,86,41,45,0,37,8,29,17,15,2,5,59.3,25.5,11.7,314478.52,176629.424
W00009052,,oa,139,116,87,29,3,8,0,8,6,6,0,6,83.5,5.8,4.3,314432,177274.78999999998
W00008881,,oa,144,90,32,58,0,21,1,20,33,28,5,0,62.5,14.6,22.9,316621.81,176217.44650000002
W00008890,,oa,124,112,66,46,0,3,2,1,8,8,0,1,90.3,2.4,6.5,315264.194,177100.826
W00009196,,oa,126,114,44,70,0,0,0,0,12,9,3,0,90.5,0.0,9.5,314631.53099999996,177737.8805
W00009042,,oa,136,63,33,30,1,59,25,34,10,8,2,3,46.3,43.4,7.4,314261.322,177840.1335
W00009187,,oa,125,87,43,44,0,22,1,21,12,11,1,4,69.6,17.6,9.6,315460.425,177665.5125
W00009219,,oa,129,99,51,48,0,8,3,5,21,19,2,1,76.7,6.2,16.3,315257.0905,178770.9665
W00009216,,oa,165,82,48,34,0,18,15,3,62,60,2,3,49.7,10.9,37.6,314846.7465,179034.2425
W00009228,,oa,143,109,56,53,0,4,1,3,28,27,1,2,76.2,2.8,19.6,314486.2705,179290.8945
W00009138,,oa,133,114,53,61,1,2,0,2,16,16,0,0,85.7,1.5,12.0,317442.204,180362.0125
W00008865,,oa,125,62,22,40,0,30,4,26,30,29,1,3,49.6,24.0,24.0,315864.754,176776.0415
W00009536,,oa,117,104,61,43,1,0,0,0,11,11,0,1,88.9,0.0,9.4,315827.94550000003,181475.577
W00009588,,oa,197,47,18,29,0,90,5,85,55,53,2,5,23.9,45.7,27.9,317279.50800000003,176539.747
W00010134,,oa,141,69,10,59,0,5,2,3,66,61,5,1,48.9,3.5,46.8,321071.977,178088.6005
W00010230,,oa,92,15,9,6,1,3,1,2,73,71,2,0,16.3,3.3,79.3,318443.753,175074.728
W00008913,,oa,159,8,4,4,0,20,3,17,131,95,36,0,5.0,12.6,82.4,318411.985,177295.14250000002
W00010153,,oa,100,50,18,32,4,1,0,1,39,37,2,6,50.0,1.0,39.0,318498.85699999996,176254.73599999998
W00009330,,oa,150,82,28,54,0,53,42,11,13,13,0,2,54.7,35.3,8.7,320893.16599999997,180476.91499999998
W00010130,,oa,119,37,9,28,0,2,0,2,77,69,8,3,31.1,1.7,64.7,318607.0605,176679.4135
W00010186,,oa,98,17,6,11,6,10,0,10,64,60,4,1,17.3,10.2,65.3,318966.55350000004,175300.3025
W00010194,,oa,137,59,8,51,1,3,0,3,74,72,2,0,43.1,2.2,54.0,319310.007,175320.0625
W00010197,,oa,128,29,7,22,0,3,1,2,96,91,5,0,22.7,2.3,75.0,319486.625,175185.9135
W00010160,,oa,95,28,9,19,1,5,5,0,58,54,4,3,29.5,5.3,61.1,318848.98600000003,174776.8245
W00010161,,oa,135,60,16,44,1,1,0,1,71,70,1,2,44.4,0.7,52.6,318245.8945,173535.3125
W00010143,,oa,107,34,14,20,0,2,1,1,70,66,4,1,31.8,1.9,65.4,318310.03500000003,173424.14500000002
W00009463,,oa,121,52,27,25,0,3,0,3,65,62,3,1,43.0,2.5,53.7,318884.7155,178060.82150000002
W00009448,,oa,180,13,6,7,0,79,1,78,88,87,1,0,7.2,43.9,48.9,318866.2085,176925.711
W00010200,,oa,137,48,11,37,0,3,0,3,86,81,5,0,35.0,2.2,62.8,318663.97349999996,174965.71250000002
W00010188,,oa,58,52,32,20,0,0,0,0,3,2,1,3,89.7,0.0,5.2,319190.65650000004,180046.599
W00010184,,oa,121,48,9,39,0,15,0,15,58,55,3,0,39.7,12.4,47.9,318984.9475,175491.454
W00009664,,oa,138,78,34,44,1,22,0,22,34,32,2,3,56.5,15.9,24.6,320132.5235,176911.369
W00008817,,oa,136,14,8,6,0,99,81,18,19,19,0,4,10.3,72.8,14.0,318872.419,175107.2645
W00008788,,oa,172,53,15,38,0,61,6,55,58,53,5,0,30.8,35.5,33.7,319473.9215,176821.278
W00010198,,oa,112,38,9,29,0,26,22,4,47,44,3,1,33.9,23.2,42.0,319019.33499999996,175076.0955
W00009331,,oa,166,100,32,68,0,48,5,43,17,14,3,1,60.2,28.9,10.2,320556.9365,181772.1095
W00010133,,oa,227,52,11,41,0,2,0,2,171,164,7,2,22.9,0.9,75.3,319622.31799999997,174723.5235
W00009611,,oa,129,118,58,60,1,3,2,1,7,6,1,0,91.5,2.3,5.4,321451.947,178866.353
W00010131,,oa,233,48,26,22,1,5,2,3,173,160,13,6,20.6,2.1,74.2,318752.796,176289.6365
W00008907,,oa,139,8,5,3,2,9,3,6,119,114,5,1,5.8,6.5,85.6,318258.2905,177611.60700000002
W00008903,,oa,136,35,27,8,0,2,1,1,99,94,5,0,25.7,1.5,72.8,318493.2965,177708.858
W00008900,,oa,156,34,24,10,0,6,2,4,115,108,7,1,21.8,3.8,73.7,318257.3255,177886.43
W00009434,,oa,172,13,5,8,0,14,3,11,143,137,6,2,7.6,8.1,83.1,318835.23600000003,177476.1085
W00009430,,oa,119,71,33,38,0,2,0,2,44,44,0,2,59.7,1.7,37.0,319142.33499999996,177641.5635
W00009438,,oa,122,51,24,27,1,9,2,7,60,57,3,1,41.8,7.4,49.2,319354.055,177487.766
W00009439,,oa,126,59,23,36,1,9,1,8,55,49,6,2,46.8,7.1,43.7,319128.6925,177430.88799999998
W00010181,,oa,118,36,6,30,6,6,4,2,68,65,3,2,30.5,5.1,57.6,319821.6315,177220.874
W00008915,,oa,157,6,6,0,2,13,6,7,136,118,18,0,3.8,8.3,86.6,318501.396,177283.1685
W00008910,,oa,140,15,8,7,1,2,0,2,122,118,4,0,10.7,1.4,87.1,318455.899,177567.27049999998
W00009387,,oa,147,94,33,61,1,31,0,31,19,18,1,2,63.9,21.1,12.9,320317.2465,178544.979
W00009386,,oa,127,48,23,25,0,71,0,71,7,5,2,1,37.8,55.9,5.5,320544.579,178639.8015
W00009301,,oa,116,30,12,18,0,75,69,6,7,6,1,4,25.9,64.7,6.0,322013.73250000004,180798.95400000003
W00009389,,oa,123,105,50,55,1,10,2,8,7,7,0,0,85.4,8.1,5.7,318903.939,178637.642
W00009407,,oa,125,110,46,64,0,1,0,1,9,9,0,5,88.0,0.8,7.2,320080.55850000004,177724.5415
W00009405,,oa,145,26,10,16,0,20,1,19,98,97,1,1,17.9,13.8,67.6,319393.44550000003,177941.19
W00009408,,oa,142,41,12,29,0,9,0,9,89,83,6,3,28.9,6.3,62.7,320665.221,178077.4225
W00009409,,oa,120,115,72,43,0,0,0,0,5,3,2,0,95.8,0.0,4.2,319593.9665,179403.875
W00009662,,oa,128,43,18,25,0,43,1,42,37,37,0,5,33.6,33.6,28.9,320059.026,176713.53999999998
W00009668,,oa,119,80,31,49,0,18,1,17,21,15,6,0,67.2,15.1,17.6,320303.61199999996,176952.82549999998
W00010196,,oa,129,64,8,56,4,8,3,5,51,47,4,2,49.6,6.2,39.5,318567.266,174930.985
W00009316,,oa,127,92,41,51,0,3,2,1,31,30,1,1,72.4,2.4,24.4,321467.1435,179481.027
W00009395,,oa,123,106,40,66,0,1,0,1,16,15,1,0,86.2,0.8,13.0,319613.981,178268.1105
W00010216,,oa,107,40,7,33,1,14,13,1,47,47,0,5,37.4,13.1,43.9,318945.1805,174828.861
W00010217,,oa,106,60,8,52,6,30,6,24,9,9,0,1,56.6,28.3,8.5,320947.028,181523.7475
W00009413,,oa,114,112,63,49,0,0,0,0,2,2,0,0,98.2,0.0,1.8,318805.46400000004,179169.4985
W00009454,,oa,94,38,19,19,3,4,2,2,46,44,2,3,40.4,4.3,48.9,318564.598,178247.516
W00009418,,oa,129,98,62,36,1,5,1,4,23,22,1,2,76.0,3.9,17.8,318736.4575,179054.2645
W00009499,,oa,123,99,23,76,1,3,2,1,20,19,1,0,80.5,2.4,16.3,320316.6625,182021.3075
W00008962,,oa,114,99,55,44,0,1,0,1,14,13,1,0,86.8,0.9,12.3,319096.204,180471.3525
W00008965,,oa,129,110,58,52,1,0,0,0,16,14,2,2,85.3,0.0,12.4,318629.45050000004,180294.299
W00008969,,oa,113,81,39,42,0,1,0,1,30,28,2,1,71.7,0.9,26.5,319053.52150000003,180050.111
W00008961,,oa,122,115,64,51,1,0,0,0,6,6,0,0,94.3,0.0,4.9,318864.3285,180544.6485
W00008807,,oa,218,97,31,66,3,37,33,4,77,74,3,4,44.5,17.0,35.3,318713.59849999996,174321.23200000002
W00008800,,oa,153,69,21,48,0,35,3,32,47,44,3,2,45.1,22.9,30.7,320036.184,177041.47950000002
W00008808,,oa,163,34,3,31,0,42,8,34,84,79,5,3,20.9,25.8,51.5,319140.8985,175923.1725
W00008947,,oa,128,102,64,38,0,1,0,1,23,22,1,2,79.7,0.8,18.0,319776.64749999996,180855.5245
W00008948,,oa,128,116,58,58,0,1,0,1,9,8,1,2,90.6,0.8,7.0,319411.795,181476.2715
W00009476,,oa,133,33,18,15,1,5,1,4,91,73,18,3,24.8,3.8,68.4,318856.15150000004,177677.5635
W00009472,,oa,123,22,12,10,0,7,2,5,93,91,2,1,17.9,5.7,75.6,319273.7925,177790.287
W00009470,,oa,111,67,31,36,0,2,1,1,42,38,4,0,60.4,1.8,37.8,319116.7035,177781.96
W00009471,,oa,225,15,8,7,1,10,4,6,197,194,3,2,6.7,4.4,87.6,318693.67949999997,177531.3145
W00009646,,oa,179,11,4,7,0,151,10,141,8,6,2,9,6.1,84.4,4.5,319595.684,176264.00449999998
W00009643,,oa,135,59,15,44,0,43,3,40,33,30,3,0,43.7,31.9,24.4,319727.1675,176427.0395
W00009648,,oa,124,36,12,24,0,77,72,5,6,5,1,5,29.0,62.1,4.8,320655.4815,177355.642
W00008976,,oa,125,94,52,42,0,1,1,0,30,27,3,0,75.2,0.8,24.0,318824.5,179531.60450000002
W00008977,,oa,123,113,50,63,0,1,1,0,9,8,1,0,91.9,0.8,7.3,318475.04449999996,179482.6015
W00008973,,oa,135,112,68,44,0,1,1,0,20,20,0,2,83.0,0.7,14.8,319181.4855,179596.131
W00008970,,oa,115,105,66,39,0,0,0,0,9,9,0,1,91.3,0.0,7.8,318802.55700000003,179876.62300000002
W00009109,,oa,103,42,24,18,0,50,47,3,9,9,0,2,40.8,48.5,8.7,318431.908,174789.9105
W00008813,,oa,137,56,19,37,0,4,0,4,75,70,5,2,40.9,2.9,54.7,319041.2025,175654.3915
W00009361,,oa,158,88,40,48,1,52,47,5,17,14,3,0,55.7,32.9,10.8,320299.1185,179726.0005
W00009443,,oa,126,43,17,26,1,13,0,13,69,67,2,0,34.1,10.3,54.8,318990.135,177443.653
W00009469,,oa,106,46,25,21,1,4,3,1,53,49,4,2,43.4,3.8,50.0,318869.923,177868.27850000001
W00009462,,oa,128,38,15,23,1,6,3,3,77,74,3,6,29.7,4.7,60.2,319197.2115,177990.13
W00009466,,oa,114,40,22,18,0,1,1,0,72,65,7,1,35.1,0.9,63.2,319038.13049999997,177887.3775
W00009461,,oa,124,39,18,21,0,4,1,3,79,77,2,2,31.5,3.2,63.7,319072.605,178139.50699999998
W00009655,,oa,136,68,34,34,0,48,30,18,17,15,2,3,50.0,35.3,12.5,320875.6995,177209.9495
W00009657,,oa,111,62,16,46,0,38,2,36,8,8,0,3,55.9,34.2,7.2,320577.531,177505.59600000002
W00009656,,oa,222,65,11,54,1,115,23,92,40,37,3,1,29.3,51.8,18.0,321301.05449999997,176503.1
W00009652,,oa,136,69,24,45,0,49,43,6,13,12,1,5,50.7,36.0,9.6,320934.713,177381.31650000002
W00009650,,oa,115,90,17,73,1,3,2,1,18,15,3,3,78.3,2.6,15.7,321396.213,177398.24099999998
W00009651,,oa,149,77,26,51,0,44,35,9,24,22,2,4,51.7,29.5,16.1,320844.2845,177519.21000000002
W00009659,,oa,121,82,36,46,0,16,9,7,23,23,0,0,67.8,13.2,19.0,320535.50049999997,177081.212
W00009658,,oa,114,77,36,41,0,17,15,2,16,16,0,4,67.5,14.9,14.0,320848.2585,177046.454
W00010172,,oa,131,84,22,62,0,20,17,3,23,18,5,4,64.1,15.3,17.6,321526.8125,177431.41100000002
W00009371,,oa,138,97,31,66,0,20,2,18,21,18,3,0,70.3,14.5,15.2,320277.046,181742.271
W00008921,,oa,122,64,26,38,1,1,0,1,56,52,4,0,52.5,0.8,45.9,318415.8365,178296.0055
W00010142,,oa,155,95,34,61,0,32,1,31,28,24,4,0,61.3,20.6,18.1,320195.746,178167.299
W00010127,,oa,134,41,16,25,1,4,2,2,85,84,1,3,30.6,3.0,63.4,319368.226,173977.5005
W00009626,,oa,142,107,70,37,0,8,1,7,27,27,0,0,75.4,5.6,19.0,321751.20999999996,179651.347
W00009625,,oa,116,37,18,19,0,64,41,23,12,12,0,3,31.9,55.2,10.3,322171.2215,179463.5855
W00009623,,oa,124,110,60,50,0,5,2,3,9,8,1,0,88.7,4.0,7.3,321992.10549999995,179580.0795
W00010147,,oa,142,68,24,44,0,2,0,2,68,57,11,4,47.9,1.4,47.9,319405.15150000004,174981.5615
W00008956,,oa,129,119,74,45,0,0,0,0,10,9,1,0,92.2,0.0,7.8,319282.06200000003,180863.772
W00008950,,oa,130,115,61,54,0,2,0,2,12,10,2,1,88.5,1.5,9.2,318774.2355,181252.5115
W00009982,,oa,104,3,0,3,1,46,14,32,54,48,6,0,2.9,44.2,51.9,319013.34699999995,176390.36599999998
W00009346,,oa,128,74,25,49,1,34,29,5,16,15,1,3,57.8,26.6,12.5,320082.25,180500.603
W00009344,,oa,156,67,19,48,0,68,60,8,18,17,1,3,42.9,43.6,11.5,320014.62549999997,180659.69
W00008922,,oa,162,31,12,19,1,5,0,5,123,114,9,2,19.1,3.1,75.9,318281.5455,178307.21850000002
W00009343,,oa,124,88,33,55,0,11,2,9,25,23,2,0,71.0,8.9,20.2,320176.6185,181014.85
W00009445,,oa,141,31,10,21,0,60,2,58,47,47,0,3,22.0,42.6,33.3,319489.8895,177177.983
W00009447,,oa,144,33,15,18,0,63,0,63,44,39,5,4,22.9,43.8,30.6,319366.02249999996,177192.325
W00009444,,oa,137,62,28,34,0,14,3,11,58,51,7,3,45.3,10.2,42.3,319117.252,177338.109
W00009442,,oa,119,29,17,12,0,24,1,23,66,64,2,0,24.4,20.2,55.5,319506.1925,177366.336
W00009441,,oa,154,44,21,23,0,33,24,9,70,64,6,7,28.6,21.4,45.5,319078.6345,177220.878
W00009449,,oa,204,50,31,19,1,7,0,7,144,131,13,2,24.5,3.4,70.6,318997.4385,176904.55599999998
W00009637,,oa,132,64,23,41,0,34,0,34,32,29,3,2,48.5,25.8,24.2,320329.5965,176467.21899999998
W00009635,,oa,124,74,37,37,0,24,3,21,23,20,3,3,59.7,19.4,18.5,320053.4095,176600.0565
W00009630,,oa,181,62,21,41,0,57,8,49,56,49,7,6,34.3,31.5,30.9,320037.5,176361.3695
W00009639,,oa,136,99,43,56,0,20,0,20,17,15,2,0,72.8,14.7,12.5,320374.94550000003,176517.008
W00010159,,oa,112,90,32,58,0,2,1,1,19,14,5,1,80.4,1.8,17.0,320259.578,177959.8305
W00009357,,oa,116,55,18,37,0,49,44,5,10,9,1,2,47.4,42.2,8.6,320531.918,180189.37550000002
W00009355,,oa,108,95,42,53,0,5,5,0,8,8,0,0,88.0,4.6,7.4,319645.405,180093.5795
W00009352,,oa,131,64,23,41,0,49,47,2,16,16,0,2,48.9,37.4,12.2,320149.261,180396.67700000003
W00009350,,oa,109,71,33,38,0,34,0,34,4,3,1,0,65.1,31.2,3.7,319465.7825,180394.80099999998
W00009358,,oa,136,31,14,17,1,92,89,3,9,9,0,3,22.8,67.6,6.6,320192.975,180027.3245
W00009451,,oa,154,59,21,38,0,9,0,9,86,84,2,0,38.3,5.8,55.8,318507.78949999996,178695.33500000002
W00009459,,oa,145,29,14,15,0,4,0,4,112,108,4,0,20.0,2.8,77.2,319079.7485,178346.0235
W00008786,,oa,141,59,22,37,1,44,15,29,36,32,4,1,41.8,31.2,25.5,319795.08999999997,176709.54100000003
W00008784,,oa,160,68,23,45,0,41,1,40,48,47,1,3,42.5,25.6,30.0,319924.571,176935.2865
W00008780,,oa,127,63,20,43,1,35,4,31,25,25,0,3,49.6,27.6,19.7,320017.569,177153
W00009607,,oa,135,109,53,56,0,1,0,1,23,22,1,2,80.7,0.7,17.0,321728.671,179091.9605
W00009608,,oa,129,124,62,62,0,1,1,0,3,3,0,1,96.1,0.8,2.3,321507.6715,179049.44
W00008930,,oa,144,26,10,16,2,3,1,2,111,108,3,2,18.1,2.1,77.1,318417.7695,177960.28399999999
W00009321,,oa,109,53,19,34,0,43,38,5,12,11,1,1,48.6,39.4,11.0,322205.46900000004,181522.5485
W00008795,,oa,169,83,33,50,0,20,2,18,64,58,6,2,49.1,11.8,37.9,320010.034,177376.92599999998
W00009426,,oa,124,64,31,33,0,6,2,4,53,47,6,1,51.6,4.8,42.7,318719.97199999995,178073.397
W00009425,,oa,125,48,20,28,0,9,5,4,67,64,3,1,38.4,7.2,53.6,319314.26249999995,177096.913
W00009423,,oa,174,40,22,18,0,35,8,27,97,94,3,2,23.0,20.1,55.7,319382.233,177815.16600000003
W00008792,,oa,120,39,23,16,1,41,4,37,33,31,2,6,32.5,34.2,27.5,319480.234,176481.4
W00008799,,oa,167,63,29,34,0,22,1,21,80,77,3,2,37.7,13.2,47.9,320159.89749999996,177372.45299999998
W00008798,,oa,166,106,40,66,2,12,7,5,41,36,5,5,63.9,7.2,24.7,320269.65599999996,177350.4675
W00008804,,oa,155,88,38,50,1,13,6,7,48,43,5,5,56.8,8.4,31.0,318545.35,174315.5565
W00010149,,oa,148,45,6,39,0,0,0,0,103,101,2,0,30.4,0.0,69.6,317960.61950000003,173322.288
W00010138,,oa,126,31,6,25,0,4,2,2,90,86,4,1,24.6,3.2,71.4,318183.8515,173392.698
W00010170,,oa,95,42,14,28,2,39,25,14,7,7,0,5,44.2,41.1,7.4,317813.7035,173965.9925
W00010154,,oa,135,55,21,34,2,4,2,2,72,68,4,2,40.7,3.0,53.3,318686.49199999997,174672.148
W00010139,,oa,203,52,27,25,0,7,1,6,144,137,7,0,25.6,3.4,70.9,319622.854,174448.446
W00010137,,oa,280,55,24,31,1,2,1,1,214,203,11,8,19.6,0.7,76.4,318676.0115,176040.896
W00010212,,oa,68,7,6,1,0,41,2,39,20,20,0,0,10.3,60.3,29.4,317527.934,177777.869
W00009645,,oa,209,28,9,19,1,105,16,89,73,71,2,2,13.4,50.2,34.9,320153.646,176168.311
W00010178,,oa,97,16,8,8,1,24,15,9,56,25,31,0,16.5,24.7,57.7,317138.25600000005,178163.10450000002
W00009181,,oa,116,104,61,43,0,0,0,0,10,8,2,2,89.7,0.0,8.6,319481.62549999997,183640.25
W00007425,,oa,171,154,76,78,0,0,0,0,11,10,1,6,90.1,0.0,6.4,322052.74600000004,186157.725
W00010219,,oa,80,9,6,3,0,9,4,5,61,55,6,1,11.3,11.3,76.3,318437.728,177450.9545
W00009161,,oa,165,131,57,74,0,0,0,0,33,30,3,1,79.4,0.0,20.0,316361.702,180503.12
W00010208,,oa,160,9,4,5,0,10,0,10,129,126,3,12,5.6,6.3,80.6,318353.32200000004,176059.8875
W00009073,,oa,145,74,26,48,0,53,50,3,11,10,1,7,51.0,36.6,7.6,316641.757,178816.923
W00009090,,oa,128,107,42,65,1,3,0,3,15,13,2,2,83.6,2.3,11.7,318141.51450000005,174643.75
W00010199,,oa,128,63,14,49,10,26,2,24,28,25,3,1,49.2,20.3,21.9,316945.8125,181505.686
W00009126,,oa,150,122,38,84,1,1,0,1,26,23,3,0,81.3,0.7,17.3,316933.387,175703.597
W00010168,,oa,114,53,5,48,3,25,5,20,33,29,4,0,46.5,21.9,28.9,317786.41099999996,173911.8315
W00009336,,oa,131,90,41,49,0,2,1,1,39,36,3,0,68.7,1.5,29.8,319816.59349999996,181082.1355
W00009695,,oa,110,68,22,46,0,23,12,11,18,17,1,1,61.8,20.9,16.4,324225.7305,181190.80550000002
W00009147,,oa,125,90,52,38,0,3,1,2,29,24,5,3,72.0,2.4,23.2,316691.0635,179829.147
W00009144,,oa,111,95,49,46,1,3,3,0,12,12,0,0,85.6,2.7,10.8,316450.61100000003,179919.948
W00009145,,oa,129,105,52,53,0,1,1,0,21,20,1,2,81.4,0.8,16.3,316693.106,180016.38150000002
W00009436,,oa,136,67,27,40,3,6,0,6,58,52,6,2,49.3,4.4,42.6,319248.604,177604.9845
W00008926,,oa,122,64,40,24,1,2,0,2,55,51,4,0,52.5,1.6,45.1,317729.658,178171.3075
W00009159,,oa,185,132,75,57,0,3,2,1,46,42,4,4,71.4,1.6,24.9,316646.5135,180572.2895
W00009151,,oa,137,115,54,61,1,5,1,4,15,12,3,1,83.9,3.6,10.9,316702.30299999996,179591.9505
W00009305,,oa,119,77,33,44,1,23,21,2,16,12,4,2,64.7,19.3,13.4,322450.57550000004,180511.7875
W00010206,,oa,93,17,6,11,1,28,6,22,44,42,2,3,18.3,30.1,47.3,319304.767,176456.4745
W00009253,,oa,116,74,33,41,0,28,24,4,10,8,2,4,63.8,24.1,8.6,317632.651,181380
W00009565,,oa,148,85,33,52,1,21,6,15,40,36,4,1,57.4,14.2,27.0,317217.14650000003,176257.39049999998
W00009562,,oa,136,18,9,9,3,68,56,12,44,42,2,3,13.2,50.0,32.4,317133.435,176385.84649999999
W00009561,,oa,137,45,14,31,0,69,63,6,18,17,1,5,32.8,50.4,13.1,316758.5825,176268.4535
W00009667,,oa,101,78,27,51,0,8,2,6,15,13,2,0,77.2,7.9,14.9,320395.52749999997,176889.14549999998
W00009661,,oa,130,91,33,58,0,11,6,5,27,23,4,1,70.0,8.5,20.8,320272.3345,177169.293
W00010117,,oa,138,17,7,10,0,5,0,5,103,96,7,13,12.3,3.6,74.6,317907.454,177159.7735
W00009123,,oa,173,66,26,40,2,78,22,56,27,25,2,0,38.2,45.1,15.6,317462.36199999996,175758.7145
W00009396,,oa,166,98,43,55,0,2,1,1,64,64,0,2,59.0,1.2,38.6,319570.9385,178291.9025
W00010214,,oa,132,69,10,59,2,11,0,11,48,48,0,2,52.3,8.3,36.4,316775.7365,181228.03
W00010211,,oa,86,51,4,47,6,1,0,1,27,27,0,1,59.3,1.2,31.4,317607.6495,173252.3555
W00009574,,oa,141,36,19,17,0,64,6,58,37,33,4,4,25.5,45.4,26.2,317353.11,176028.103
W00009572,,oa,198,47,16,31,2,43,3,40,100,94,6,6,23.7,21.7,50.5,317830.19550000003,176015.05550000002
W00009573,,oa,122,63,33,30,1,20,3,17,33,29,4,5,51.6,16.4,27.0,317446.047,176081
W00009570,,oa,153,51,30,21,0,21,8,13,75,73,2,6,33.3,13.7,49.0,317602.0985,176054.753
W00009578,,oa,133,82,41,41,0,1,0,1,50,48,2,0,61.7,0.8,37.6,316689.83999999997,177465.6665
W00009136,,oa,139,84,29,55,1,11,2,9,41,39,2,2,60.4,7.9,29.5,317518.71849999996,175488.585
W00009135,,oa,119,77,51,26,1,9,3,6,28,23,5,4,64.7,7.6,23.5,317761.55350000004,175488.276
W00009132,,oa,112,53,19,34,1,18,1,17,39,38,1,1,47.3,16.1,34.8,317794.0555,175342.138
W00009133,,oa,136,112,54,58,2,5,5,0,15,13,2,2,82.4,3.7,11.0,317044.68799999997,175367.3495
W00008882,,oa,131,69,35,34,0,39,4,35,19,17,2,4,52.7,29.8,14.5,316460.32550000004,176111.6825
W00008880,,oa,175,84,29,55,0,56,3,53,33,33,0,2,48.0,32.0,18.9,316520.409,176247.961
W00009477,,oa,168,133,57,76,1,10,8,2,21,20,1,3,79.2,6.0,12.5,323255.925,181615.6195
W00009233,,oa,136,113,53,60,0,15,8,7,7,6,1,1,83.1,11.0,5.1,316575.0075,179084.0775
W00009543,,oa,129,117,61,56,0,0,0,0,11,10,1,1,90.7,0.0,8.5,316590.19499999995,181193.52850000001
W00009732,,oa,104,79,48,31,1,0,0,0,23,22,1,1,76.0,0.0,22.1,316436.4885,179673.082
W00009647,,oa,118,4,1,3,0,101,8,93,8,5,3,5,3.4,85.6,6.8,320147.25,175626.0005
W00009649,,oa,129,63,18,45,0,47,43,4,14,13,1,5,48.8,36.4,10.9,320938.042,177636.9595
W00008979,,oa,117,112,69,43,0,0,0,0,5,5,0,0,95.7,0.0,4.3,319440.0145,181969.0655
W00009105,,oa,153,63,29,34,0,13,0,13,74,70,4,3,41.2,8.5,48.4,317665.876,175084.346
W00009363,,oa,153,95,37,58,0,4,2,2,54,52,2,0,62.1,2.6,35.3,319969.3765,179742.14250000002
W00008899,,oa,132,34,21,13,0,3,0,3,91,88,3,4,25.8,2.3,68.9,317943.82999999996,177800.701
W00008818,,oa,213,47,14,33,3,85,74,11,74,73,1,4,22.1,39.9,34.7,318713.828,175089.338
W00009365,,oa,121,63,34,29,0,39,37,2,18,18,0,1,52.1,32.2,14.9,320222.8635,179556.27750000003
W00009369,,oa,141,110,47,63,2,17,8,9,9,7,2,3,78.0,12.1,6.4,320144.868,181780.8825
W00009285,,oa,127,80,37,43,0,27,23,4,16,12,4,4,63.0,21.3,12.6,316964.121,182274.0185
W00009284,,oa,137,93,33,60,0,30,26,4,14,13,1,0,67.9,21.9,10.2,317268.3225,182253.8075
W00009288,,oa,131,79,28,51,0,42,38,4,6,3,3,4,60.3,32.1,4.6,316683.201,182225.4975
W00009558,,oa,173,70,29,41,0,31,16,15,67,65,2,5,40.5,17.9,38.7,316723.3415,176640.4325
W00010224,,oa,79,43,19,24,0,9,3,6,27,23,4,0,54.4,11.4,34.2,317591.03500000003,175741.638
W00009706,,oa,124,45,4,41,0,53,1,52,25,23,2,1,36.3,42.7,20.2,324139.6675,180590.1265
W00009653,,oa,142,64,22,42,0,54,45,9,14,13,1,10,45.1,38.0,9.9,321162.1365,177422.6955
W00010176,,oa,176,115,21,94,3,9,2,7,47,43,4,2,65.3,5.1,26.7,316868.773,181118.6445
W00010173,,oa,124,42,15,27,0,5,4,1,77,71,6,0,33.9,4.0,62.1,317284.35349999997,174033.1485
W00009110,,oa,141,95,45,50,0,13,4,9,31,27,4,2,67.4,9.2,22.0,317837.5365,174869.299
W00009290,,oa,129,77,32,45,0,35,32,3,13,13,0,4,59.7,27.1,10.1,316687.0245,182032.40899999999
W00009521,,oa,130,118,91,27,0,1,0,1,9,8,1,2,90.8,0.8,6.9,316369.614,182160.18300000002
W00009624,,oa,169,65,25,40,1,71,36,35,28,27,1,4,38.5,42.0,16.6,322459.576,179437.9505
W00009629,,oa,148,94,43,51,2,24,2,22,27,25,2,1,63.5,16.2,18.2,320230.017,176771.6165
W00008955,,oa,132,126,75,51,0,0,0,0,6,5,1,0,95.5,0.0,4.5,319052.373,181045.1645
W00008958,,oa,133,123,89,34,0,1,0,1,7,6,1,2,92.5,0.8,5.3,319362.7735,180670.72
W00009340,,oa,132,40,6,34,1,66,65,1,25,23,2,0,30.3,50.0,18.9,320710.4275,181084.886
W00009082,,oa,140,61,34,27,1,13,3,10,64,58,6,1,43.6,9.3,45.7,317230.4515,179105.7495
W00010157,,oa,111,89,18,71,1,1,0,1,20,18,2,0,80.2,0.9,18.0,321673.966,182049.0765
W00008927,,oa,127,56,33,23,1,2,1,1,67,57,10,1,44.1,1.6,52.8,317853.77099999995,178028.776
W00008925,,oa,143,52,28,24,0,5,1,4,86,78,8,0,36.4,3.5,60.1,317923.1355,178189.0755
W00008877,,oa,139,88,38,50,1,8,2,6,40,36,4,2,63.3,5.8,28.8,316610.664,176459.511
W00008875,,oa,152,116,46,70,1,4,1,3,29,24,5,2,76.3,2.6,19.1,316361.83499999996,176436.631
W00008878,,oa,120,82,34,48,0,4,2,2,34,30,4,0,68.3,3.3,28.3,316275.069,176362.263
W00009083,,oa,131,89,35,54,0,4,3,1,38,30,8,0,67.9,3.1,29.0,317672.8985,179016.201
W00009081,,oa,133,74,32,42,3,3,2,1,50,43,7,3,55.6,2.3,37.6,317300.5,178542.70299999998
W00009263,,oa,185,134,22,112,11,1,0,1,39,37,2,0,72.4,0.5,21.1,317250.283,183557.02250000002
W00009500,,oa,111,98,20,78,0,3,0,3,9,9,0,1,88.3,2.7,8.1,319942.10699999996,182070.146
W00009582,,oa,155,62,25,37,0,8,0,8,85,84,1,0,40.0,5.2,54.8,316894.7595,177232.5215
W00009584,,oa,133,92,36,56,0,7,0,7,33,32,1,1,69.2,5.3,24.8,316415.05,177158.505
W00009583,,oa,165,86,38,48,2,5,0,5,71,68,3,1,52.1,3.0,43.0,316567.5265,177137.0455
W00009589,,oa,136,68,30,38,0,10,3,7,57,56,1,1,50.0,7.4,41.9,316699.966,177021.6775
W00009456,,oa,119,58,30,28,1,6,1,5,53,51,2,1,48.7,5.0,44.5,318654.4305,178264.0365
W00009457,,oa,146,70,30,40,0,0,0,0,76,72,4,0,47.9,0.0,52.1,318814.99950000003,178315.089
W00009452,,oa,130,60,23,37,0,9,0,9,61,58,3,0,46.2,6.9,46.9,318577.6645,178500.68300000002
W00009453,,oa,151,70,26,44,2,6,4,2,71,68,3,2,46.4,4.0,47.0,318679.136,178622.986
W00008782,,oa,158,60,15,45,1,46,5,41,47,45,2,4,38.0,29.1,29.7,319789.7835,176961.87099999998
W00009682,,oa,155,44,11,33,1,94,80,14,14,12,2,2,28.4,60.6,9.0,323213.6435,181075
W00009174,,oa,134,125,60,65,0,0,0,0,9,8,1,0,93.3,0.0,6.7,317053.38800000004,180160.32150000002
W00009173,,oa,115,103,55,48,0,0,0,0,10,10,0,2,89.6,0.0,8.7,317354.99,180180.7095
W00009179,,oa,122,121,70,51,0,0,0,0,1,1,0,0,99.2,0.0,0.8,318198.4255,182883.8185
W00009097,,oa,142,77,26,51,1,32,30,2,30,29,1,2,54.2,22.5,21.1,317460.7885,175218.83299999998
W00009096,,oa,173,69,29,40,1,43,2,41,57,56,1,3,39.9,24.9,32.9,317932.4895,175206.45899999997
W00009095,,oa,135,60,26,34,0,29,8,21,45,39,6,1,44.4,21.5,33.3,317632.92350000003,175299.842
W00009092,,oa,149,66,13,53,0,4,1,3,78,74,4,1,44.3,2.7,52.3,318017.869,173723.8965
W00010229,,oa,79,69,39,30,0,2,0,2,5,2,3,3,87.3,2.5,6.3,319188.882,178856.7685
W00010226,,oa,76,49,19,30,0,16,14,2,9,5,4,2,64.5,21.1,11.8,317024.5,178592.46000000002
W00010222,,oa,120,101,45,56,0,8,6,2,11,9,2,0,84.2,6.7,9.2,316776.75,181602.273
W00010220,,oa,118,59,22,37,1,33,27,6,21,17,4,4,50.0,28.0,17.8,317094.297,178416.89
W00009276,,oa,134,128,67,61,1,2,1,1,3,3,0,0,95.5,1.5,2.2,318060.7065,182439.6615
W00009272,,oa,133,116,52,64,0,0,0,0,16,14,2,1,87.2,0.0,12.0,317847.88300000003,182844.252
W00009271,,oa,114,100,48,52,1,3,1,2,10,10,0,0,87.7,2.6,8.8,317624.0315,182831.727
W00009278,,oa,136,103,48,55,1,2,2,0,28,26,2,2,75.7,1.5,20.6,316650.64249999996,182516.93050000002
W00009596,,oa,115,65,22,43,0,8,1,7,42,41,1,0,56.5,7.0,36.5,317173.643,176671.193
W00009595,,oa,184,107,45,62,0,5,1,4,67,61,6,5,58.2,2.7,36.4,317241.79099999997,176690.02049999998
W00009593,,oa,107,64,21,43,0,2,0,2,40,40,0,1,59.8,1.9,37.4,316912.1,176863.1295
W00009592,,oa,151,54,19,35,0,4,1,3,89,87,2,4,35.8,2.6,58.9,317368.15150000004,176975.072
W00009590,,oa,115,76,34,42,0,1,0,1,37,35,2,1,66.1,0.9,32.2,317021,176970.6225
W00008793,,oa,211,15,6,9,1,167,4,163,26,24,2,2,7.1,79.1,12.3,319211.114,176305.49349999998
W00010210,,oa,88,26,10,16,1,0,0,0,60,58,2,1,29.5,0.0,68.2,320840.70550000004,170171.3125
W00009067,,oa,123,82,37,45,1,25,24,1,14,10,4,1,66.7,20.3,11.4,313887.9035,178316.142
W00009066,,oa,163,81,39,42,0,66,31,35,14,11,3,2,49.7,40.5,8.6,313234.31299999997,178405.56449999998
W00009063,,oa,119,95,39,56,0,9,7,2,14,14,0,1,79.8,7.6,11.8,313429.1455,178635.05550000002
W00009064,,oa,127,70,23,47,0,40,38,2,14,13,1,3,55.1,31.5,11.0,313876.3955,178402.72350000002
W00009060,,oa,134,102,41,61,1,3,3,0,25,23,2,3,76.1,2.2,18.7,313490.177,178921.14750000002
W00009065,,oa,142,82,23,59,0,44,42,2,12,11,1,4,57.7,31.0,8.5,313955.1315,178147.2225
W00009061,,oa,148,106,45,61,0,3,2,1,38,36,2,1,71.6,2.0,25.7,314051.5565,178633.8935
W00009068,,oa,130,102,54,48,1,4,3,1,22,21,1,1,78.5,3.1,16.9,314192.515,178184.33299999998
W00008827,,oa,139,83,37,46,0,39,1,38,16,13,3,1,59.7,28.1,11.5,312293.298,175155.2585
W00008826,,oa,167,103,22,81,0,29,3,26,34,29,5,1,61.7,17.4,20.4,312646.07149999996,175021.06650000002
W00009069,,oa,159,79,30,49,0,71,63,8,8,8,0,1,49.7,44.7,5.0,313118.7405,178201.0325
W00008822,,oa,134,116,63,53,0,6,2,4,12,11,1,0,86.6,4.5,9.0,314389.8835,176524.186
W00008825,,oa,132,79,34,45,0,35,32,3,14,13,1,4,59.8,26.5,10.6,313409.65599999996,175793.2355
W00008823,,oa,143,70,23,47,0,58,52,6,11,9,2,4,49.0,40.6,7.7,313776.49,175953.5635
W00008821,,oa,204,170,56,114,1,11,2,9,21,16,5,1,83.3,5.4,10.3,312288.457,174928.97950000002
W00008828,,oa,139,98,30,68,2,11,1,10,28,27,1,0,70.5,7.9,20.1,313046.153,174822.3985
W00008829,,oa,137,102,52,50,4,6,3,3,22,21,1,3,74.5,4.4,16.1,314986.586,176332.104
W00009385,,oa,134,117,53,64,0,4,2,2,12,12,0,1,87.3,3.0,9.0,311880.402,183522.8985
W00005992,,oa,156,136,66,70,0,2,2,0,15,13,2,3,87.2,1.3,9.6,310961.67350000003,171845.64299999998
W00005765,,oa,128,113,57,56,0,4,3,1,9,9,0,2,88.3,3.1,7.0,314624.11600000004,173765.6015
W00009854,,oa,126,112,55,57,0,0,0,0,14,12,2,0,88.9,0.0,11.1,312331.7975,174390.93550000002
W00005995,,oa,117,115,81,34,0,0,0,0,2,1,1,0,98.3,0.0,1.7,312051.858,173196.1255
W00005994,,oa,121,112,63,49,0,0,0,0,7,6,1,2,92.6,0.0,5.8,311840.292,172839.0515
W00005990,,oa,133,121,68,53,0,6,6,0,5,4,1,1,91.0,4.5,3.8,312276.6975,173635.64549999998
W00005882,,oa,169,128,71,57,0,8,8,0,27,27,0,6,75.7,4.7,16.0,310169.1555,176797.0515
W00009046,,oa,159,51,17,34,0,90,77,13,15,12,3,3,32.1,56.6,9.4,313890.7605,177727.359
W00009047,,oa,123,68,25,43,1,18,12,6,35,31,4,1,55.3,14.6,28.5,313262.118,177495.484
W00009044,,oa,113,74,31,43,0,1,1,0,34,30,4,4,65.5,0.9,30.1,313442.9695,177573.086
W00008995,,oa,126,55,10,45,1,55,53,2,12,9,3,3,43.7,43.7,9.5,313470.4755,176713.7035
W00008992,,oa,134,55,21,34,0,66,65,1,9,8,1,4,41.0,49.3,6.7,313432.0775,177003.41749999998
W00008820,,oa,198,130,37,93,1,43,21,22,24,21,3,0,65.7,21.7,12.1,313179.507,175032.7625
W00008836,,oa,119,29,16,13,0,79,75,4,9,9,0,2,24.4,66.4,7.6,314101.182,175995.175
W00009072,,oa,120,70,31,39,3,20,17,3,24,19,5,3,58.3,16.7,20.0,312835.4135,178020.21649999998
W00009070,,oa,134,88,36,52,1,36,33,3,8,8,0,1,65.7,26.9,6.0,313335.8785,178134.2005
W00009071,,oa,142,48,20,28,0,69,64,5,19,19,0,6,33.8,48.6,13.4,313534.52599999995,178085.0415
W00008837,,oa,142,66,26,40,2,56,39,17,16,15,1,2,46.5,39.4,11.3,313838.68,175775.215
W00008834,,oa,122,38,10,28,0,69,67,2,8,7,1,7,31.1,56.6,6.6,313891.24199999997,175936.9945
W00008844,,oa,126,77,38,39,0,30,26,4,17,14,3,2,61.1,23.8,13.5,312806.19,175489.0855
W00009011,,oa,121,28,13,15,0,82,77,5,9,8,1,2,23.1,67.8,7.4,313033.60250000004,176265.945
W00010192,,oa,126,88,25,63,1,13,1,12,24,22,2,0,69.8,10.3,19.0,313682.30350000004,179748.2875
W00008987,,oa,117,59,20,39,0,44,39,5,12,11,1,2,50.4,37.6,10.3,312666.0635,175577.414
W00008986,,oa,126,44,18,26,0,61,60,1,16,15,1,5,34.9,48.4,12.7,312798.2255,176503.8355
W00008985,,oa,132,38,8,30,0,82,79,3,10,10,0,2,28.8,62.1,7.6,312958.51399999997,176743.298
W00008989,,oa,144,124,68,56,0,6,2,4,11,10,1,3,86.1,4.2,7.6,311895.342,175389.739
W00008984,,oa,153,136,48,88,0,5,5,0,10,9,1,2,88.9,3.3,6.5,311414.59900000005,175638.66499999998
W00008983,,oa,118,111,62,49,1,1,1,0,3,2,1,2,94.1,0.8,2.5,311748.323,175914.253
W00008982,,oa,136,65,30,35,0,63,45,18,7,7,0,1,47.8,46.3,5.1,313281.7855,175952.5785
W00008981,,oa,150,47,21,26,0,84,72,12,17,17,0,2,31.3,56.0,11.3,313433.64,176186.2035
W00008988,,oa,144,21,11,10,0,110,49,61,4,1,3,9,14.6,76.4,2.8,312233.1625,175421.56
W00008852,,oa,120,36,15,21,0,69,68,1,11,11,0,4,30.0,57.5,9.2,313125.957,175483.9015
W00008850,,oa,145,85,34,51,1,29,19,10,29,27,2,1,58.6,20.0,20.0,312851.7035,175069.3865
W00008851,,oa,123,63,25,38,0,44,41,3,13,13,0,3,51.2,35.8,10.6,313178.3905,175289.869
W00009740,,oa,230,78,19,59,1,128,83,45,23,21,2,0,33.9,55.7,10.0,313732.13049999997,180986.962
W00010182,,oa,130,114,44,70,0,2,1,1,13,13,0,1,87.7,1.5,10.0,313515.864,180101.947
W00010185,,oa,126,93,16,77,0,12,0,12,21,18,3,0,73.8,9.5,16.7,313946.3905,180156.7875
W00008997,,oa,111,27,8,19,0,69,68,1,14,13,1,1,24.3,62.2,12.6,313218.4035,176745.9945
W00008996,,oa,123,45,15,30,0,66,63,3,11,10,1,1,36.6,53.7,8.9,314072.6685,176728.74
W00008991,,oa,127,119,65,54,0,3,3,0,5,5,0,0,93.7,2.4,3.9,311753.281,175038.2495
W00008990,,oa,132,114,51,63,0,3,2,1,15,9,6,0,86.4,2.3,11.4,311647.3585,175387.06699999998
W00008999,,oa,133,62,28,34,0,58,56,2,11,10,1,2,46.6,43.6,8.3,312709.22849999997,176686.46
W00009751,,oa,184,156,54,102,0,6,5,1,20,17,3,2,84.8,3.3,10.9,314102.877,180424.1145
W00009129,,oa,138,86,49,37,0,12,4,8,33,32,1,7,62.3,8.7,23.9,317673.815,175636.2565
W00008835,,oa,121,63,32,31,0,42,38,4,13,11,2,3,52.1,34.7,10.7,314185.8095,175895.9145
W00008832,,oa,124,71,33,38,2,41,5,36,8,8,0,2,57.3,33.1,6.5,314619.899,176286.5005
W00006526,,oa,128,90,39,51,1,35,16,19,2,1,1,0,70.3,27.3,1.6,312739.32149999996,183448.293
W00009723,,oa,119,72,35,37,0,38,16,22,7,6,1,2,60.5,31.9,5.9,314442,179820.2595
W00009672,,oa,108,4,1,3,0,104,2,102,0,0,0,0,3.7,96.3,0.0,323770.7645,180509.5075
W00009041,,oa,131,59,23,36,0,57,55,2,9,7,2,6,45.0,43.5,6.9,313609.391,177846.16249999998
W00009048,,oa,133,111,56,55,0,4,3,1,14,14,0,4,83.5,3.0,10.5,313928.2355,177361.445
W00009049,,oa,130,9,2,7,0,112,13,99,7,6,1,2,6.9,86.2,5.4,313068.22900000005,177386.2195
W00008946,,oa,171,149,34,115,0,2,1,1,20,20,0,0,87.1,1.2,11.7,312196.56499999994,176312.278
W00009235,,oa,122,91,38,53,1,1,1,0,28,25,3,1,74.6,0.8,23.0,314937.32050000003,178714.517
W00009238,,oa,141,104,47,57,0,21,20,1,13,13,0,3,73.8,14.9,9.2,315275.966,178952.6875
W00009546,,oa,109,95,64,31,0,0,0,0,13,12,1,1,87.2,0.0,11.9,316123.4975,181328.48700000002
W00010163,,oa,116,108,25,83,0,1,0,1,6,6,0,1,93.1,0.9,5.2,312217.7795,181787.278
W00009104,,oa,156,58,16,42,0,35,17,18,59,56,3,4,37.2,22.4,37.8,317546.2325,175039.474
W00009102,,oa,127,85,34,51,0,13,1,12,29,27,2,0,66.9,10.2,22.8,317165.79850000003,175043.2355
W00009057,,oa,127,93,32,61,0,16,6,10,14,12,2,4,73.2,12.6,11.0,314259.7885,177040.8605
W00009050,,oa,116,43,18,25,0,62,13,49,11,9,2,0,37.1,53.4,9.5,313328.2385,177217.52899999998
W00009059,,oa,133,102,57,45,0,21,14,7,6,4,2,4,76.7,15.8,4.5,313086.7175,178629.2005
W00008891,,oa,117,86,39,47,0,15,5,10,16,14,2,0,73.5,12.8,13.7,315722.2025,177157.7595
W00009206,,oa,124,114,47,67,0,3,2,1,4,3,1,3,91.9,2.4,3.2,313587.56649999996,179297.759
W00009208,,oa,137,130,75,55,0,3,0,3,2,2,0,2,94.9,2.2,1.5,313841.3575,178951.543
W00009209,,oa,117,92,44,48,1,2,1,1,22,22,0,0,78.6,1.7,18.8,314082.5415,178977.0845
W00009193,,oa,123,72,42,30,0,1,0,1,47,44,3,3,58.5,0.8,38.2,315784.7955,178010.899
W00009191,,oa,236,159,72,87,2,36,0,36,39,39,0,0,67.4,15.3,16.5,314404.4875,178977.3025
W00009027,,oa,130,45,17,28,0,71,64,7,13,13,0,1,34.6,54.6,10.0,312706.586,175770.09999999998
W00009020,,oa,118,32,9,23,0,70,66,4,12,10,2,4,27.1,59.3,10.2,312787.98549999995,176013.139
W00009029,,oa,121,63,34,29,0,43,41,2,11,9,2,4,52.1,35.5,9.1,313716.968,178417.285
W00009373,,oa,132,106,40,66,2,14,1,13,10,8,2,0,80.3,10.6,7.6,320286.579,181541.89
W00009212,,oa,104,85,34,51,0,1,0,1,18,16,2,0,81.7,1.0,17.3,314304.838,178665.0795
W00009529,,oa,134,124,65,59,0,1,1,0,9,8,1,0,92.5,0.7,6.7,314874.70149999997,182356.24800000002
W00009717,,oa,133,115,50,65,0,2,0,2,15,15,0,1,86.5,1.5,11.3,312990.168,182382.664
W00009718,,oa,141,120,50,70,0,10,1,9,11,10,1,0,85.1,7.1,7.8,313466.506,181823.38400000002
W00010144,,oa,122,109,61,48,0,0,0,0,12,12,0,1,89.3,0.0,9.8,311261.906,178674.0855
W00009347,,oa,98,57,17,40,0,29,28,1,12,10,2,0,58.2,29.6,12.2,320540.631,180522.9605
W00009036,,oa,131,85,40,45,0,37,30,7,9,6,3,0,64.9,28.2,6.9,313391.20550000004,177828.7135
W00009037,,oa,133,71,40,31,0,48,45,3,6,6,0,8,53.4,36.1,4.5,313732.45550000004,177910.90899999999
W00009034,,oa,137,92,43,49,0,22,22,0,21,19,2,2,67.2,16.1,15.3,314229.436,177522.2895
W00009038,,oa,147,30,7,23,1,105,104,1,8,8,0,3,20.4,71.4,5.4,313156.833,178027.58299999998
W00009039,,oa,124,101,25,76,1,8,6,2,14,12,2,0,81.5,6.5,11.3,312707.5725,178080.69900000002
W00009345,,oa,140,70,17,53,1,55,34,21,12,12,0,2,50.0,39.3,8.6,320362.489,180432.419
W00009007,,oa,126,42,25,17,0,77,73,4,7,6,1,0,33.3,61.1,5.6,313841.483,176410.2515
W00009004,,oa,131,43,17,26,0,75,71,4,12,11,1,1,32.8,57.3,9.2,313933.33050000004,176608.1445
W00009005,,oa,128,33,9,24,0,73,70,3,18,17,1,4,25.8,57.0,14.1,313013.30449999997,176483.2135
W00009002,,oa,158,56,21,35,0,88,65,23,12,11,1,2,35.4,55.7,7.6,313562,176536.5
W00009003,,oa,129,50,18,32,0,65,63,2,11,11,0,3,38.8,50.4,8.5,313447.3495,176468.722
W00009001,,oa,128,46,11,35,0,66,64,2,14,14,0,2,35.9,51.6,10.9,313840.67949999997,176802.446
W00009008,,oa,125,32,9,23,1,76,72,4,15,14,1,1,25.6,60.8,12.0,313131.58499999996,176456.374
W00009506,,oa,128,125,63,62,0,0,0,0,2,2,0,1,97.7,0.0,1.6,312542.095,181125.16700000002
W00009769,,oa,122,52,24,28,0,46,46,0,22,18,4,2,42.6,37.7,18.0,315697.001,179673.56050000002
W00008843,,oa,147,46,20,26,0,95,82,13,4,4,0,2,31.3,64.6,2.7,313945.545,175571.6655
W00008842,,oa,130,86,39,47,0,29,28,1,14,9,5,1,66.2,22.3,10.8,312999.08550000004,175627.0885
W00008840,,oa,122,50,20,30,0,56,26,30,14,14,0,2,41.0,45.9,11.5,314329.7525,175628.448
W00008841,,oa,128,85,38,47,0,19,19,0,20,16,4,4,66.4,14.8,15.6,313415.8915,175653.34350000002
W00009016,,oa,103,19,6,13,0,77,77,0,7,6,1,0,18.4,74.8,6.8,312603.45849999995,176048.26799999998
W00009017,,oa,113,90,48,42,0,17,17,0,6,6,0,0,79.6,15.0,5.3,312163.1725,175953.20299999998
W00009015,,oa,137,125,48,77,1,4,1,3,6,5,1,1,91.2,2.9,4.4,311401.2695,175984.3455
W00009013,,oa,134,81,34,47,0,45,45,0,6,6,0,2,60.4,33.6,4.5,313661.74199999997,176140.776
W00009010,,oa,126,32,8,24,0,79,69,10,8,7,1,7,25.4,62.7,6.3,312783.2975,176170.8725
W00009018,,oa,136,42,18,24,0,85,84,1,6,5,1,3,30.9,62.5,4.4,313222.8155,176093.46
W00009511,,oa,140,130,81,49,0,4,0,4,5,5,0,1,92.9,2.9,3.6,313061.8545,180336.83649999998
W00008994,,oa,124,69,27,42,1,41,40,1,12,10,2,1,55.6,33.1,9.7,314139.359,176636.55849999998
W00008998,,oa,156,71,28,43,0,39,36,3,42,37,5,4,45.5,25.0,26.9,314386.791,176744.8205
W00008993,,oa,132,72,35,37,0,41,30,11,17,13,4,2,54.5,31.1,12.9,314215.58400000003,176933.39049999998
W00008853,,oa,135,93,32,61,0,2,1,1,38,37,1,2,68.9,1.5,28.1,315256.38800000004,176840.82
W00008854,,oa,128,112,50,62,0,1,1,0,13,13,0,2,87.5,0.8,10.2,315014.54500000004,176970.495
W00010209,,oa,136,81,38,43,1,38,0,38,14,14,0,2,59.6,27.9,10.3,315424.0895,176375.858
W00008858,,oa,108,93,41,52,0,2,1,1,10,10,0,3,86.1,1.9,9.3,315384.5955,176911
W00008857,,oa,142,76,26,50,1,25,2,23,38,36,2,2,53.5,17.6,26.8,315879.9175,176896.4345
W00009194,,oa,141,111,69,42,0,3,0,3,25,21,4,2,78.7,2.1,17.7,314612.605,178026.1435
W00010231,,oa,104,96,48,48,0,1,0,1,7,7,0,0,92.3,1.0,6.7,314569.44499999995,178473.5
W00010187,,oa,46,41,28,13,0,1,1,0,3,2,1,1,89.1,2.2,6.5,314861.819,178302.24
W00009213,,oa,123,112,69,43,1,1,0,1,7,7,0,2,91.1,0.8,5.7,314758.6125,178544.6785
W00009210,,oa,115,77,30,47,1,2,1,1,34,31,3,1,67.0,1.7,29.6,314297.1705,178925.55349999998
W00009240,,oa,120,84,28,56,1,24,18,6,8,4,4,3,70.0,20.0,6.7,315597.372,178624.519
W00009079,,oa,188,80,37,43,0,64,26,38,41,38,3,3,42.6,34.0,21.8,317051.2955,178740.58250000002
W00009742,,oa,133,122,71,51,0,0,0,0,11,10,1,0,91.7,0.0,8.3,314766.25450000004,181101
W00009741,,oa,138,123,69,54,0,4,2,2,8,8,0,3,89.1,2.9,5.8,314542.9275,181192.45500000002
W00009614,,oa,132,119,53,66,0,1,0,1,11,11,0,1,90.2,0.8,8.3,321291.94299999997,178533.7695
W00009696,,oa,132,97,32,65,0,4,2,2,31,27,4,0,73.5,3.0,23.5,324415.0165,181066.231
W00009062,,oa,140,106,38,68,1,4,2,2,29,27,2,0,75.7,2.9,20.7,314267.6665,178366.38549999997
W00008824,,oa,174,70,25,45,0,97,43,54,6,5,1,1,40.2,55.7,3.4,314666.615,175927.576
W00009752,,oa,99,90,77,13,2,1,0,1,6,6,0,0,90.9,1.0,6.1,314590.151,180617.19050000003
W00009753,,oa,112,87,52,35,2,2,0,2,20,20,0,1,77.7,1.8,17.9,315401.70149999997,180394.6745
W00009221,,oa,116,73,21,52,0,31,22,9,9,9,0,3,62.9,26.7,7.8,316192.978,178705.49349999998
W00008886,,oa,128,119,63,56,0,2,0,2,6,6,0,1,93.0,1.6,4.7,315514.277,177260.429
W00008809,,oa,131,15,12,3,0,60,37,23,45,45,0,11,11.5,45.8,34.4,318418.85,175519.956
W00009239,,oa,121,56,23,33,0,52,47,5,10,10,0,3,46.3,43.0,8.3,316110.84349999996,178779.4765
W00009544,,oa,118,113,63,50,0,1,0,1,4,4,0,0,95.8,0.8,3.4,316477.767,181060.35950000002
W00009738,,oa,116,112,73,39,0,1,1,0,3,2,1,0,96.6,0.9,2.6,316114.048,179320.3985
W00009739,,oa,136,126,71,55,0,3,3,0,7,5,2,0,92.6,2.2,5.1,314383.476,181352.9345
W00009054,,oa,136,124,60,64,1,2,1,1,9,8,1,0,91.2,1.5,6.6,314198.269,177282.2935
W00009055,,oa,166,112,50,62,0,38,4,34,16,16,0,0,67.5,22.9,9.6,314501.5235,177322.87699999998
W00009053,,oa,118,81,40,41,1,6,1,5,29,26,3,1,68.6,5.1,24.6,314482.15650000004,177124.8505
W00009058,,oa,143,95,52,43,1,6,2,4,40,39,1,1,66.4,4.2,28.0,314632.49950000003,177065.68099999998
W00008895,,oa,119,88,33,55,0,3,0,3,27,24,3,1,73.9,2.5,22.7,316111.797,176971.56949999998
W00008892,,oa,118,107,55,52,0,3,2,1,5,4,1,3,90.7,2.5,4.2,315435.968,177152.6755
W00009202,,oa,114,97,33,64,1,0,0,0,16,15,1,0,85.1,0.0,14.0,314686.6625,177478.9535
W00009207,,oa,119,104,43,61,1,0,0,0,13,12,1,1,87.4,0.0,10.9,314403.79500000004,178929.065
W00009200,,oa,121,109,59,50,0,1,1,0,10,10,0,1,90.1,0.8,8.3,315199.2875,177759.01
W00009280,,oa,126,117,55,62,1,2,1,1,4,3,1,2,92.9,1.6,3.2,317756.3955,182344.42450000002
W00009707,,oa,113,1,1,0,0,107,5,102,5,5,0,0,0.9,94.7,4.4,323681.294,180667.1875
W00009465,,oa,141,33,18,15,0,11,0,11,95,88,7,2,23.4,7.8,67.4,318712.5145,177906.05
W00009708,,oa,113,2,1,1,0,111,4,107,0,0,0,0,1.8,98.2,0.0,323901.11600000004,180559.4105
W00009192,,oa,129,90,55,35,0,9,1,8,26,22,4,4,69.8,7.0,20.2,315387.1675,178186.516
W00009211,,oa,112,102,51,51,0,1,0,1,9,6,3,0,91.1,0.9,8.0,314165.5015,178740.23599999998
W00009520,,oa,116,110,58,52,0,0,0,0,5,4,1,1,94.8,0.0,4.3,315489.50450000004,182085.73450000002
W00008868,,oa,151,93,42,51,2,12,2,10,41,39,2,3,61.6,7.9,27.2,315925.61600000004,176631.4385
W00009531,,oa,123,116,76,40,0,2,1,1,5,4,1,0,94.3,1.6,4.1,314661.57050000003,181469.217
W00009634,,oa,120,95,41,54,0,9,3,6,15,12,3,1,79.2,7.5,12.5,320458.7025,176702.59149999998
W00009165,,oa,114,106,56,50,0,0,0,0,7,7,0,1,93.0,0.0,6.1,316075.29,180537.25449999998
W00009168,,oa,115,103,72,31,0,1,0,1,10,8,2,1,89.6,0.9,8.7,315922.42850000004,180389.313
W00008874,,oa,141,103,48,55,0,3,2,1,33,33,0,2,73.0,2.1,23.4,316136.777,176466.9045
W00009768,,oa,133,112,69,43,1,3,2,1,16,15,1,1,84.2,2.3,12.0,315530.091,179786.03
W00008933,,oa,124,37,17,20,1,2,1,1,83,78,5,1,29.8,1.6,66.9,317956.137,177979.425
W00009099,,oa,117,99,46,53,0,1,0,1,16,11,5,1,84.6,0.9,13.7,318205.2675,174959.15600000002
W00009320,,oa,118,60,19,41,0,43,35,8,14,14,0,1,50.8,36.4,11.9,322409.5,181614.28399999999
W00009275,,oa,111,100,48,52,0,1,1,0,8,8,0,2,90.1,0.9,7.2,317637.924,182598.9725
W00009273,,oa,118,88,34,54,2,6,0,6,20,18,2,2,74.6,5.1,16.9,317153.67449999996,182900.342
W00009519,,oa,121,108,70,38,0,2,0,2,11,10,1,0,89.3,1.7,9.1,315765.748,182039.057
W00008790,,oa,131,28,7,21,1,41,7,34,59,59,0,2,21.4,31.3,45.0,319344.72250000003,176509.1485
W00008607,,oa,162,141,79,62,1,8,3,5,10,8,2,2,87.0,4.9,6.2,327037.3645,181138.44449999998
W00008605,,oa,123,107,56,51,0,4,2,2,9,6,3,3,87.0,3.3,7.3,324377.4535,184327.44650000002
W00009694,,oa,140,84,37,47,0,37,32,5,17,14,3,2,60.0,26.4,12.1,323066.8495,181184.75449999998
W00009715,,oa,131,6,1,5,0,117,9,108,8,4,4,0,4.6,89.3,6.1,322912.62049999996,179825.93349999998
W00009698,,oa,117,78,17,61,8,12,3,9,18,17,1,1,66.7,10.3,15.4,324396.7885,180913.8805
W00009692,,oa,142,119,32,87,0,2,0,2,21,20,1,0,83.8,1.4,14.8,324471.79099999997,181346.5565
W00010183,,oa,114,88,7,81,0,2,1,1,24,23,1,0,77.2,1.8,21.1,324335.07200000004,179931.04950000002
W00009669,,oa,193,6,0,6,0,182,10,172,3,1,2,2,3.1,94.3,1.6,323858.101,180837.9585
W00009677,,oa,132,114,37,77,0,0,0,0,18,16,2,0,86.4,0.0,13.6,324353.5775,181662.546
W00009671,,oa,107,3,0,3,0,102,8,94,2,2,0,0,2.8,95.3,1.9,324123.7265,180677.01549999998
W00009679,,oa,158,133,40,93,3,3,0,3,18,17,1,1,84.2,1.9,11.4,324410.017,181503.9385
W00009705,,oa,118,105,20,85,1,0,0,0,12,10,2,0,89.0,0.0,10.2,324524.2295,180737.505
W00009703,,oa,100,3,0,3,0,91,3,88,5,5,0,1,3.0,91.0,5.0,324094.091,180919.69900000002
W00009701,,oa,106,44,24,20,0,52,48,4,7,7,0,3,41.5,49.1,6.6,323023.8375,180642.7405
W00009714,,oa,113,70,27,43,0,28,21,7,12,12,0,3,61.9,24.8,10.6,323083.586,180069.5975
W00009681,,oa,128,47,19,28,0,60,54,6,16,16,0,5,36.7,46.9,12.5,323077.0335,180988.059
W00009523,,oa,221,202,87,115,2,4,2,2,11,9,2,2,91.4,1.8,5.0,315558.047,183356.4475
W00009375,,oa,185,159,76,83,0,15,15,0,9,6,3,2,85.9,8.1,4.9,311308.50899999996,183743.306
W00009761,,oa,119,98,40,58,0,11,9,2,8,8,0,2,82.4,9.2,6.7,314613.65650000004,180004.402
W00009605,,oa,132,112,53,59,0,1,0,1,19,16,3,0,84.8,0.8,14.4,322230.234,179063.18550000002
W00009328,,oa,140,127,68,59,0,2,2,0,9,9,0,2,90.7,1.4,6.4,322704.703,181379.19449999998
W00009087,,oa,129,73,37,36,1,2,0,2,51,48,3,2,56.6,1.6,39.5,317650.414,178851.8775
W00009089,,oa,113,36,14,22,1,6,0,6,66,61,5,4,31.9,5.3,58.4,317821.06799999997,178825.85950000002
W00009384,,oa,130,114,74,40,0,3,2,1,11,10,1,2,87.7,2.3,8.5,311085.843,181762.2505
W00006518,,oa,146,96,40,56,1,11,6,5,37,30,7,1,65.8,7.5,25.3,312191.46550000005,183384.202
W00006524,,oa,132,95,42,53,0,27,8,19,9,8,1,1,72.0,20.5,6.8,311964.7435,183804.6335
W00008959,,oa,120,104,66,38,0,1,0,1,15,14,1,0,86.7,0.8,12.5,318352.28449999995,180532.70150000002
W00009260,,oa,125,72,32,40,0,36,35,1,13,12,1,4,57.6,28.8,10.4,317763.517,181121.8965
W00009719,,oa,133,46,13,33,1,71,1,70,13,10,3,2,34.6,53.4,9.8,314204.39650000003,182708.2035
W00009349,,oa,154,100,39,61,0,33,30,3,17,15,2,4,64.9,21.4,11.0,319784,180548.9815
W00009265,,oa,129,86,26,60,1,0,0,0,41,37,4,1,66.7,0.0,31.8,317654.65150000004,183316.4185
W00009712,,oa,136,82,40,42,0,32,23,9,20,19,1,2,60.3,23.5,14.7,323316.1975,180259.293
W00009183,,oa,163,155,68,87,0,0,0,0,6,6,0,2,95.1,0.0,3.7,318101.90650000004,183206.35
W00009688,,oa,135,117,37,80,2,1,1,0,14,13,1,1,86.7,0.7,10.4,325172.588,180975.974
W00009176,,oa,157,141,80,61,0,2,2,0,10,10,0,4,89.8,1.3,6.4,317936.31350000005,183488.78149999998
W00009177,,oa,129,105,56,49,3,7,7,0,10,8,2,4,81.4,5.4,7.8,318901.564,183262.72950000002
